ano	ano	ənó(ʔ)
chishno	chishno	
yamma	yamma	
pishno	pishno	
hachishno	hachishno	hət͡ʃɪʃnó(ʔ)
yamma	yamma	
-pa	-pa	
-ma	-ma	
pa	pa	
ma	ma	
kata	kata	
nata	nata	
katimma	katimma	
katimi	katimi	
katimichi	katimichi	
kiyo	kiyo	
mo̱ma	mo̱ma	
lawa	lawa	laˈwa(h)
kanohmi	kanohmi	kanohəmí(h)
kanohmi	kanohmi	kanohəmí(h)
i̱la	i̱la	
achaffa	achaffa	
toklo	toklo	
tochchina	tochchina	
oshta	oshta	
talhlhapi	talhlhapi	
chito	chito	tʃitó(ʔ)
falaya	falaya	
patha	patha	
sokko	sokko	
wiki	wiki	
chipo̱ta	chipo̱ta	
kolhkoki	kolhkoki	
atikkonofa	atikkonofa	
tapaski	tapaski	
ohoyo	ohoyo	ohoːjó
nakni	nakni	
hattak	hattak	hət.tə́k
alla	alla	əl.lá
tikchi	tikchi	tiktʃí
hattak	hattak	hət.tə́k
ishki	ishki	ɪʃkí
i̱ki	i̱ki	ĩːkí(ʔ)
powa	powa	
nani	nani	nəní(ʔ)
hoshi	hoshi	
ofi	ofi	ofí(ʔ)
issap	issap	ɪs.sə́p
si̱ti	si̱ti	sĩːtí
ha̲shwish	ha̲shwish	
itti	itti	
ko̱wi	ko̱wi	kõːwí(ʔ)
ititana̱pa	ititana̱pa	
ani	ani	aní(ʔ)
atia	atia	
hishi	hishi	
ashkatala	ashkatala	
akchalhpi	akchalhpi	
himmita	himmita	
hashshok	hashshok	həʃ.ʃók
asita	asita	
hakshop	hakshop	
nipi	nipi	
issish	issish	
foni	foni	fóni
bila	bila	bilá
aka̱kushi	aka̱kushi	
lapish	lapish	
hasi̱bish	hasi̱bish	
hishi	hishi	
pa̱shi	pa̱shi	
noshkobo	noshkobo	
haksobish	haksobish	həksobɪ́ʃ
nishkin	nishkin	
ibishakni	ibishakni	ɪbiːʃə́kni(ʔ)
itakha	itakha	
noti	noti	
isso̱lash	isso̱lash	
ibbak chosh	ibbak chosh	
iyyi	iyyi	
hanali	hanali	
ittolhpi	ittolhpi	
ibbak	ibbak	
ali	ali	
iffoka	iffoka	if.foká
iskona	iskona	iskʊná(ʔ)
ikko̱la	ikko̱la	ɪk.kṍːla(ʔ)
olbal	olbal	
ikkishii	ikkishii	
cho̱kash	cho̱kash	tʃõːkə́ʃ
issalakha	issalakha	
ishko	ishko	
apa	apa	
kapoli	kapoli	
pishi	pishi	
tufa	tufa	
howita	howita	
mahli	mahli	məhlí(ʔ)
fiopa	fiopa	
yoppa	yoppa	
pisa	pisa	
haklo	haklo	
ikha̱na	ikha̱na	
ahni	ahni	
hu̱wa	hu̱wa	
nokshopa	nokshopa	
nosi	nosi	
okchaya	okchaya	
illi	illi	
abi	abi	
itibbi	itibbi	
abi	abi	
isso	isso	
bashli	bashli	
palhali	palhali	
bali	bali	
kalaffi	kalaffi	
itakshish kulli	itakshish kulli	
okshinilli	okshinilli	
hika	hika	
nowa	nowa	
minti	minti	
itula	itula	
binili	binili	
atelifa	atelifa	
afinni	afinni	
ittula	ittula	
ima	ima	
hokli	hokli	
bocholi	bocholi	
munfa	munfa	
achefa	achefa	
kasholichi	kasholichi	
halvlli	halvlli	
tobli	tobli	
pila	pila	
takchi	takchi	
achunli	achunli	
hotina	hotina	
aachi	aachi	
taloa	taloa	
olachi	olachi	
okpalali	okpalali	
yanvlli	yanvlli	
kalampi	kalampi	
chitoli	chitoli	
hvshi	hvshi	həshí(ʔ)
hvshi ninak a̲ya	hvshi ninak a̲ya	
fichik	fichik	
oka	oka	
o̱ba	o̱ba	
bok	bok	
haiyip	haiyip	
okhuta chito	okhuta chito	
hvpi	hvpi	
tali	tali	
shinuk	shinuk	
hittuk	hittuk	
yakni	yakni	
hoshonti	hoshonti	
oktohbi	oktohbi	
shutik	shutik	
mahli	mahli	məhlí(ʔ)
oktusha	oktusha	
okti	okti	
shoboli	shoboli	
lowak	lowak	
hitokchobi	hitokchobi	
libbi	libbi	
hina	hina	
nvnih chaha	nvnih chaha	
homma	homma	
okchamali	okchamali	
lakna	lakna	
tohbi	tohbi	
lusa	lusa	
ninak	ninak	
nittak	nittak	
afvmmi	afvmmi	
libisha	libisha	
kapvssa	kapvssa	
kaiya	kaiya	
himona	himona	himóːna
hlipa	hlipa	
achukma	achukma	ətʃʊ́kma
okpúlo	okpúlo	
shua	shua	
litiha	litiha	
anli	anli	
lumbo	lumbo	
halukpa	halukpa	
ik halukpo	ik halukpo	
halasbi	halasbi	
lvcha	lvcha	
shileli	shileli	
a̲hli	a̲hli	
bili̲ka	bili̲ka	
inhopaki	inhopaki	
isht impak imma	isht impak imma	
afabi	afabi	
itoma	itoma	
anu̲ka	anu̲ka	
awant	awant	
micha	micha	
ikma	ikma	
kanimi na	kanimi na	
hohchifo	hohchifo	hʊçtʃifó