mi	mi	
bo	bo	
e	e	
nos	nos	
boso	boso	
nan	nan	
aki	aki	
esei	esei	
aki	aki	
aya	aya	
ken	ken	
ki	ki	
unda	unda	
ki ora	ki ora	
kon	kon	
no	no	
tur	tur	
hopi	hopi	
algun	algun	
poko	poko	
otro	otro	
un	un	
dos	dos	
tres	tres	
kuater	kuater	
sinku	sinku	
grandi	grandi	
largu	largu	
anchu	anchu	
diki	diki	
pisá	pisá	
chikí	chikí	
kòrtiku	kòrtiku	
smal	smal	
delegá	delegá	
muhé	muhé	
hòmber	hòmber	
hende	hende	
yu	yu	
esposa	esposa	
esposo	esposo	
mama	mama	
tata	tata	
bestia	bestia	
piská	piská	
para	para	
kachó	kachó	
pieu	pieu	
kolebra	kolebra	
bichi	bichi	
palu	palu	
mondi	mondi	
baston	baston	
fruta	fruta	
simia	simia	
blachi	blachi	
rais	rais	
kaska	kaska	
flor	flor	
yerba	yerba	
kabuya	kabuya	
kueru	kueru	
karni	karni	
sanger	sanger	
wesu	wesu	
vèt	vèt	
webu	webu	
kachu	kachu	
rabu	rabu	
pluma	pluma	
kabei	kabei	
kabes	kabes	
orea	orea	
wowo	wowo	
nanishi	nanishi	
boka	boka	
djente	djente	
lenga	lenga	
uña	uña	
pia	pia	
pia	pia	
rudia	rudia	
man	man	
ala	ala	
barika	barika	
tripa	tripa	
garganta	garganta	
lomba	lomba	
pechu	pechu	
kurason	kurason	
higra	higra	
bebe	bebe	
kome	kome	
morde	morde	
chupa	chupa	
skupi	skupi	
arohá	arohá	
supla	supla	
hala rosea	hala rosea	
hari	hari	
mira	mira	
tende	tende	
sa	sa	
pensa	pensa	
ole	ole	
tin miedu	tin miedu	
drumi	drumi	
biba	biba	
muri	muri	
mata	mata	
bringa	bringa	
yag	yag	
raka	raka	
kòrta	kòrta	
separá	separá	
hinka	hinka	
huña	huña	
koba	koba	
landa	landa	
bula	bula	
kana	kana	
bin	bin	
keda	keda	
sinta	sinta	
para	para	
drai	drai	
kai	kai	
duna	duna	
tene	tene	
primi	primi	
frega	frega	
laba	laba	
bari	bari	
hala	hala	
pusha	pusha	
benta	benta	
mara	mara	
kose	kose	
konta	konta	
bisa	bisa	
kanta	kanta	
hunga	hunga	
drif	drif	
kore	kore	
fris	fris	
hincha	hincha	
solo	solo	
luna	luna	
strea	strea	
awa	awa	
awaseru	awaseru	
riu	riu	
lago	lago	
laman	laman	
salu	salu	
piedra	piedra	
santu	santu	
stòf	stòf	
tera	tera	
nubia	nubia	
neblina	neblina	
shelu	shelu	
bientu	bientu	
sneu	sneu	
eis	eis	
huma	huma	
kandela	kandela	
shinishi	shinishi	
kima	kima	
kaminda	kaminda	
seru	seru	
kòrá	kòrá	
bèrdè	bèrdè	
hel	hel	
blanku	blanku	
pretu	pretu	
nochi	nochi	
dia	dia	
aña	aña	
kayente	kayente	
friu	friu	
yen	yen	
nobo	nobo	
bieu	bieu	
bon	bon	
malu	malu	
putrí	putrí	
sushi	sushi	
stret	stret	
rònt	rònt	
skèrpi	skèrpi	
bòt	bòt	
lizu	lizu	
muhá	muhá	
seku	seku	
korekto	korekto	
serka	serka	
leu	leu	
drechi	drechi	
robes	robes	
na	na	
den	den	
ku	ku	
i	i	
si	si	
komo	komo	
nòmber	nòmber	