anga	anga	
na·a	na·a	
bia	bia	
chinga	chinga	
na·simang	na·simang	
bisimang	bisimang	
ia	ia	
ua	ua	
iano	iano	
uano	uano	
sawa	sawa	
mai	mai	
bachi	bachi	
basako	basako	
maidake	maidake	
-ja-	-ja-	
gimik	gimik	
bang·a	bang·a	
adita	adita	
komibata	komibata	
gipin	gipin	
sa	sa	
gni	gni	
gittam	gittam	
bri	bri	bri
bonga	bonga	
dal·a	dal·a	
sikbea	sikbea	
apala	apala	
ritchara	ritchara	
jrima	jrima	
chona	chona	
kan·dika	kan·dika	
apchona	apchona	
ba·a	ba·a	
me·chik	me·chik	
me·asa	me·asa	
mande	mande	
bi·sa	bi·sa	
jikgipa	jikgipa	
segipa	segipa	
ma·gipa	ma·gipa	
pagipa	pagipa	
matburing	matburing	
na·tok	na·tok	
do·o	do·o	d̪oʔo
achak	achak	at͡ɕak
tik	tik	
chipu	chipu	
kan·churi	kan·churi	
bol	bol	bol
bolgrim	bolgrim	
go·ol	go·ol	
bite	bite	
bichri	bichri	
bijak	bijak	
ja·dil	ja·dil	
bigil	bigil	
bibal	bibal	
samsi	samsi	
budu	budu	
bigil	bigil	
bitin	bitin	
an·chi	an·chi	
greng	greng	ɡreŋ
mitim	mitim	
bitchi	bitchi	
grong	grong	ɡroŋ
ki·me	ki·me	
do·kimil	do·kimil	
kimil	kimil	kʰimil
sko	sko	
nachi	nachi	
mikron	mikron	
gingting	gingting	
ku·sik	ku·sik	
wagam	wagam	waɡam
sre	sre	
jakskil	jakskil	
ja·pa	ja·pa	
ja·a	ja·a	
ja·sku	ja·sku	
jak	jak	d͡ʒak
grang	grang	
ok	ok	
bil·ikrang	bil·ikrang	
gitok	gitok	
janggil	janggil	
chel	chel	
kan·chak	kan·chak	
bike	bike	
ringa	ringa	
cha·a	cha·a	
chika	chika	
opa	opa	
stua	stua	
wakala	wakala	
bala	bala	
rang·sita	rang·sita	
ka·dinga	ka·dinga	
nika	nika	
knaa	knaa	
uia	uia	
chanchia	chanchia	
gingsika	gingsika	
kera	kera	
tusia	tusia	
tanga	tanga	
sia	sia	
so·ota	so·ota	
dinggrika	dinggrika	
sikar ka·a	sikar ka·a	
su·prua	su·prua	
din·a	din·a	
pita	pita	
su·a	su·a	
ku·aka	ku·aka	
cho·a	cho·a	
jroa	jroa	
bila	bila	
re·boa	re·boa	
re·ba	re·ba	
tua	tua	
asonga	asonga	
chadenga	chadenga	
bikpila	bikpila	
ga·aka	ga·aka	
on·a	on·a	
rim·a	rim·a	
sinjetaa	sinjetaa	
nata	nata	
su·sranga	su·sranga	
ipaka	ipaka	
sala	sala	
jitpaka	jitpaka	
goata	goata	
kaa	kaa	
sika	sika	
chana	chana	
agana	agana	
ring·a	ring·a	
kal·a	kal·a	
gitchoa	gitchoa	
jokanga	jokanga	
tin·daka	tin·daka	
gangbua	gangbua	
sal	sal	
jajong	jajong	
aski	aski	aski
chi	chi	
mikka	mikka	
chibima	chibima	
hrod	hrod	
sagal	sagal	
kari	kari	
ro·ong	ro·ong	
an·cheng	an·cheng	anʔt͡ɕeŋ
a·dumu	a·dumu	
a·a	a·a	
aram	aram	aɾam
guuri	guuri	
salgi	salgi	
bal	bal	
		
		
moila bal	moila bal	
wa·al	wa·al	
bol ma·sa	bol ma·sa	
kama	kama	
rama	rama	
a·bri	a·bri	
gitchak	gitchak	
tangsek	tangsek	
rimita	rimita	
gibok	gibok	
gisim	gisim	
wal	wal	
sal	sal	
bilsi	bilsi	
ding·a	ding·a	
sin·a	sin·a	
gapgimin	gapgimin	
gital	gital	
gitchamgipa	gitchamgipa	
nama	nama	
namgija	namgija	
sogimin	sogimin	
moilachi pindapa	moilachi pindapa	
sronga	sronga	
tom·beta	tom·beta	
mata	mata	
matgija	matgija	
rinoka	rinoka	
sosia	sosia	
ran·ata	ran·ata	
bebe	bebe	
sepang	sepang	
chel·a	chel·a	
jakra	jakra	
jakkasi	jakkasi	
-o	-o	
-o	-o	
-ming	-ming	
aro	aro	
-ode	-ode	
-na	-na	
bimung	bimung	