I	I	aɪ
you	you	juː
he	he	ˈhiː
we	we	wiː
you	you	juː
they	they	ðeɪ
this	this	ðɪs
that	that	ðæt
here	here	hɪə
there	there	ðɛə
who	who	huː
what	what	wɒt
where	where	wɛə
when	when	wɛn
how	how	haʊ
not	not	nɒt
all	all	ɔːl
many	many	ˈmɛni
some	some	sʌm
few	few	fjuː
other	other	ˈʌðə
one	one	wʌn
two	two	tuː
three	three	θɹiː
four	four	fɔː
five	five	faɪv
big	big	bɪg
long	long	lɒŋ
wide	wide	waɪd
thick	thick	θɪk
heavy	heavy	ˈhɛvi
small	small	smɔːl
short	short	ʃɔːt
narrow	narrow	ˈnæɹəʊ
thin	thin	θɪn
woman	woman	ˈwʊmən
man	man	mæn
person	person	ˈpɜːsən
child	child	ʧaɪld
wife	wife	waɪf
husband	husband	ˈhʌzbənd
mother	mother	ˈmʌðə
father	father	ˈfɑːðə
animal	animal	ˈænɪməl
fish	fish	fɪʃ
bird	bird	bɜːd
dog	dog	dɒg
louse	louse	laʊs
snake	snake	sneɪk
worm	worm	wɜːm
tree	tree	tɹiː
forest	forest	ˈfɒɹɪst
stick	stick	stɪk
fruit	fruit	fɹuːt
seed	seed	siːd
leaf	leaf	liːf
root	root	ɹuːt
bark	bark	bɑːk
flower	flower	ˈflaʊə
grass	grass	gɹɑːs
rope	rope	ɹəʊp
skin	skin	skɪn
meat	meat	miːt
blood	blood	blʌd
bone	bone	bəʊn
fat	fat	fæt
egg	egg	ɛg
horn	horn	hɔːn
tail	tail	teɪl
feather	feather	ˈfɛðə
hair	hair	hɛə
head	head	hɛd
ear	ear	ɪər
eye	eye	aɪ
nose	nose	nəʊz
mouth	mouth	maʊθ
tooth	tooth	tuːθ
tongue	tongue	tʌŋ
fingernail	fingernail	ˈfɪŋgəneɪl
foot	foot	fʊt
leg	leg	lɛg
knee	knee	niː
hand	hand	hænd
wing	wing	wɪŋ
belly	belly	ˈbɛli
guts	guts	gʌts
neck	neck	nɛk
back	back	bæk
breast	breast	bɹɛst
heart	heart	hɑːt
liver	liver	ˈlɪvə
drink	drink	dɹɪŋk
eat	eat	iːt
bite	bite	baɪt
suck	suck	sʌk
spit	spit	spɪt
vomit	vomit	ˈvɒmɪt
blow	blow	bləʊ
breathe	breathe	bɹiːð
laugh	laugh	lɑːf
see	see	siː
hear	hear	hɪə
know	know	nəʊ
think	think	θɪŋk
smell	smell	smɛl
fear	fear	fɪə
sleep	sleep	sliːp
live	live	lɪv
die	die	daɪ
kill	kill	kɪl
fight	fight	faɪt
hunt	hunt	hʌnt
hit	hit	hɪt
cut	cut	kʌt
split	split	splɪt
stab	stab	stæb
scratch	scratch	skɹæʧ
dig	dig	dɪg
swim	swim	swɪm
fly	fly	flaɪ
walk	walk	wɔːk
come	come	kʌm
lie	lie	laɪ
sit	sit	sɪt
stand	stand	stænd
turn	turn	tɜːn
fall	fall	fɔːl
give	give	gɪv
hold	hold	həʊld
squeeze	squeeze	skwiːz
rub	rub	ɹʌb
wash	wash	wɒʃ
wipe	wipe	waɪp
pull	pull	pʊl
push	push	pʊʃ
throw	throw	θɹəʊ
tie	tie	taɪ
sew	sew	səʊ
count	count	kaʊnt
say	say	seɪ
sing	sing	sɪŋ
play	play	pleɪ
float	float	fləʊt
flow	flow	fləʊ
freeze	freeze	fɹiːz
swell	swell	swɛl
sun	sun	sʌn
moon	moon	muːn
star	star	stɑː
water	water	ˈwɔːtə
rain	rain	ɹeɪn
river	river	ˈɹɪvə
lake	lake	leɪk
sea	sea	siː
salt	salt	sɔːlt
stone	stone	stəʊn
sand	sand	sænd
dust	dust	dʌst
earth	earth	ɜːθ
cloud	cloud	klaʊd
fog	fog	fɒg
sky	sky	skaɪ
wind	wind	wɪnd
snow	snow	snəʊ
ice	ice	aɪs
smoke	smoke	sməʊk
fire	fire	ˈfaɪəɹ
ash	ash	æʃ
to burn	to burn	bɜːn
road	road	ɹəʊd
mountain	mountain	ˈmaʊntɪn
red	red	rɛd
green	green	gɹiːn
yellow	yellow	ˈjɛləʊ
white	white	waɪt
black	black	blæk
night	night	naɪt
day	day	deɪ
year	year	jɪə
warm	warm	wɔːm
cold	cold	kəʊld
full	full	fʊl
new	new	njuː
old	old	əʊld
good	good	gʊd
bad	bad	bæd
rotten	rotten	ˈɹɒtən
dirty	dirty	ˈdɜːti
straight	straight	stɹeɪt
round	round	ɹaʊnd
sharp	sharp	ʃɑːp
dull	dull	dʌl
smooth	smooth	smuːð
wet	wet	wɛt
dry	dry	draɪ
correct	correct	kəˈɹɛkt
near	near	nɪə
far	far	fɑː
right	right	ɹaɪt
left	left	lɛft
at	at	æt
in	in	ɪn
with	with	wɪð
and	and	ænd
if	if	ɪf
because	because	bɪˈkɒz
name	name	neɪm