I	I	iː
thou	thou	
he	he	heː
we	we	weː
yow	yow	juː
thei	thei	
this	this	
that	that	θat
her	her	hɛːr
there	there	
who	who	hwɔː
what	what	ʍat
wher	wher	hwɛːr
whanne	whanne	ˈhwan(ə)
how	how	huː
ne	ne	nɛ
all	all	al
many	many	
som	som	sum
fewe	fewe	ˈfɛu̯(ə)
other	other	ˈoðər
oon	oon	ɔːn
two	two	twɔː
thre	thre	ˈθreː
four	four	fɔu̯r
five	five	fiːf
large	large	
long	long	lɔnɡ
brod	brod	
thikke	thikke	ˈθik(ə)
hevy	hevy	ˈhɛːviː
smal	smal	smal
schort	schort	ʃɔrt
narwe	narwe	ˈnarwə
thinne	thinne	ˈθin(ə)
womman	womman	ˈwuman
wer	wer	wɛr
man	man	
child	child	t͡ʃiːld
wif	wif	
husbonde	husbonde	ˈhu(ː)zˌbɔ(ː)nd(ə)
moder	moder	ˈmoːdər
fader	fader	ˈfa(ː)dər
beeste	beeste	ˈbɛːst(ə)
fisch	fisch	fiʃ
fowel	fowel	ˈfuːəl
hound	hound	huːnd
lous	lous	luːs
snake	snake	ˈsnaːk(ə)
worm	worm	ˈwurm
tre	tre	trøː
wald	wald	
stikke	stikke	ˈstik(ə)
frute	frute	
seed	seed	seːd
blade	blade	blaːd
rote	rote	ˈroːt(ə)
rind	rind	riːnd
flour	flour	fluːr
gras	gras	ɡras
rop	rop	rɔːp
hide	hide	
flesh	flesh	flɛːʃ
blood	blood	bloːd
bon	bon	bɔːn
fatte	fatte	
ei	ei	
horn	horn	hɔrn
teil	teil	
fether	fether	
her	her	hɛːr
heed	heed	hɛːd
ere	ere	ˈɛːr(ə)
eie	eie	ˈɛi̯(ə)
nose	nose	ˈnɔːz(ə)
mouth	mouth	muːθ
tothe	tothe	toːθ
tonge	tonge	ˈtunɡ(ə)
nayl	nayl	næi̯l
fot	fot	foːt
schanke	schanke	ˈʃank(ə)
kne	kne	knøː
hand	hand	
winge	winge	ˈwinɡ(ə)
bouk	bouk	buːk
therm	therm	
hals	hals	
rigge	rigge	
brest	brest	brøːst
herte	herte	ˈhɛrt(ə)
lyvere	lyvere	ˈlivər(ə)
drinken	drinken	
eten	eten	ˈɛːtən
biten	biten	ˈbiːtən
souken	souken	ˈsukən
spitten	spitten	
spewen	spewen	ˈspiu̯ən
blowen	blowen	ˈblɔu̯ən
brethen	brethen	
laughen	laughen	ˈlaxən
seen	seen	søːn
heren	heren	
witen	witen	
thinken	thinken	ˈθinkən
smellen	smellen	ˈsmɛlən
agasten	agasten	aˈɡastən
slepen	slepen	ˈsleːpən
lyven	lyven	ˈlivən
sterven	sterven	ˈstɛrvən
sleyen	sleyen	
fighten	fighten	
hunten	hunten	ˈhuntən
hitten	hitten	
cutten	cutten	
cleven	cleven	ˈkleːvən
percen	percen	
cracchen	cracchen	
graven	graven	ˈɡraːvən
swymmen	swymmen	ˈswimən
flien	flien	ˈfliː(ə)n
gangen	gangen	
comen	comen	ˈkumən
lien	lien	
sitten	sitten	
standen	standen	ˈstandən
turnen	turnen	
fallen	fallen	ˈfalən
yeven	yeven	ˈjeːvən
holden	holden	ˈhɔːldən
wryngen	wryngen	ˈwrinɡən
rubben	rubben	ˈrubən
wasshen	wasshen	ˈwaʃən
wipen	wipen	ˈwiːpən
pullen	pullen	
schoven	schoven	ˈʃuvən
werpen	werpen	ˈwɛrpən
teyen	teyen	ˈtɛi̯ən
sewen	sewen	
counten	counten	
quethen	quethen	ˈkwɛːðən
singen	singen	ˈsinɡən
pleyen	pleyen	ˈplæi̯ən
fleten	fleten	ˈfleːtən
flowen	flowen	ˈflɔu̯ən
fresen	fresen	ˈfreːzən
swellen	swellen	ˈswɛlən
sonne	sonne	ˈsun(ə)
mone	mone	mɔːn
sterre	sterre	ˈstɛr(ə)
water	water	ˈwatər
reyn	reyn	rɛi̯n
flod	flod	floːd
lake	lake	
see	see	sɛː
salt	salt	salt
ston	ston	stɑːn
sand	sand	saːnd
dust	dust	dust
erthe	erthe	ˈɛrð(ə)
cloud	cloud	kluːd
myst	myst	mist
welken	welken	ˈwɛlkən
wynd	wynd	wiːnd
snow	snow	snɑu̯
is	is	iːs
smeke	smeke	
fyr	fyr	fiːr
asshe	asshe	ˈaʃ(ə)
brennen	brennen	
wey	wey	wæi̯
mountayne	mountayne	muːnˈtæi̯n(ə)
red	red	rɛːd
grene	grene	ˈɡreːn(ə)
yelow	yelow	ˈjɛlɔu̯
whit	whit	hwiːt
blak	blak	blak
nyght	nyght	nixt
day	day	daj
yere	yere	
warm	warm	warm
cold	cold	kɔːld
ful	ful	
newe	newe	ˈniu̯(ə)
old	old	
good	good	ɡoːd
yvel	yvel	ˈivəl
foule	foule	
unclene	unclene	
right	right	rixt
rounde	rounde	ruːnd
scharp	scharp	
blont	blont	
smethe	smethe	ˈsmeːð(ə)
wet	wet	wɛt
drye	drye	ˈdriː(ə)
right	right	rixt
nere	nere	
fer	fer	fɛr
right	right	rixt
left	left	
on	on	
in	in	in
mid	mid	mid
and	and	and
if	if	if
for	for	
name	name	ˈnaːm(ə)