ğŒ¹ğŒº	ik	ik
ğŒ¸ğŒ¿	Ã¾u	Î¸uË
ğŒ¹ğƒ	is	
ğ…ğŒ´ğŒ¹ğƒ	weis	wiËs
ğŒ¾ğŒ¿ğƒ	jus	juËs
ğŒ´ğŒ¹ğƒ	eis	
ğƒğŒ°	sa	sa
ğƒğŒ°	sa	sa
ğŒ·ğŒ´ğ‚	hÄ“r	
ğŒ¸ğŒ°ğ‚	Ã¾ar	Î¸ar
ğˆğŒ°ğƒ	Æ•as	Êas
ğˆğŒ°	Æ•a	
ğˆğŒ°ğ‚	Æ•ar	Êar
ğˆğŒ°ğŒ½	Æ•an	Êan
ğˆğŒ°ğŒ¹ğ…ğŒ°	Æ•aiwa	
ğŒ½ğŒ¹	ni	
ğŒ°ğŒ»ğŒ»ğƒ	alls	
ğ†ğŒ¹ğŒ»ğŒ¿	filu	Ëˆfi.lu
ğƒğŒ¿ğŒ¼ğƒ	sums	
ğ†ğŒ°ğŒ¿ğƒ	faus	
ğŒ°ğŒ½ğŒ¸ğŒ°ğ‚	anÃ¾ar	Ëˆan.Î¸ar
ğŒ°ğŒ¹ğŒ½ğƒ	ains	
ğ„ğ…ğŒ°ğŒ¹	twai	ËˆtwÉ›Ë
ğŒ¸ğ‚ğŒ´ğŒ¹ğƒ	Ã¾reis	ËˆÎ¸riËs
ğ†ğŒ¹ğŒ³ğ…ğ‰ğ‚	fidwÅr	ËˆÉ¸id.woËr
ğ†ğŒ¹ğŒ¼ğ†	fimf	ËˆÉ¸imÉ¸
ğŒ¼ğŒ¹ğŒºğŒ¹ğŒ»ğƒ	mikils	
ğŒ»ğŒ°ğŒ²ğŒ²ğƒ	laggs	laÅ‹É¡s
ğŒ±ğ‚ğŒ°ğŒ¹ğŒ¸ğƒ	braiÃ¾s	
ğŒ³ğŒ¹ğŒ²ğ‚ğƒ	digrs	
ğŒºğŒ°ğŒ¿ğ‚ğŒ¿ğƒ	kaurus	
ğŒ»ğŒ´ğŒ¹ğ„ğŒ¹ğŒ»ğƒ	leitils	
		
ğŒ°ğŒ²ğŒ²ğ…ğŒ¿ğƒ	aggwus	
		
ğŒµğŒ¹ğŒ½ğ‰	qinÅ	ËˆkÊ·i.noË
ğŒ¼ğŒ°ğŒ½ğŒ½ğŒ°	manna	
ğŒ¼ğŒ°ğŒ½ğŒ½ğŒ°	manna	
ğŒ±ğŒ°ğ‚ğŒ½	barn	
ğŒµğŒ´ğŒ½ğƒ	qÄ“ns	kÊ·eËns
ğŒ°ğŒ±ğŒ°	aba	
ğŒ°ğŒ¹ğŒ¸ğŒ´ğŒ¹	aiÃ¾ei	ËˆÉ›Ë.Î¸iË
ğŒ°ğ„ğ„ğŒ°	atta	
ğŒ³ğŒ¹ğŒ¿ğƒ	dius	ËˆdiuÌ¯s
ğ†ğŒ¹ğƒğŒºğƒ	fisks	Ëˆfisks
ğ†ğŒ¿ğŒ²ğŒ»ğƒ	fugls	ËˆfuÉ¡ls
ğŒ·ğŒ¿ğŒ½ğŒ³ğƒ	hunds	Ëˆhunds
		
ğ…ğŒ°ğŒ¿ğ‚ğŒ¼ğƒ	waurms	ËˆwÉ”rms
ğŒ¼ğŒ°ğŒ¸ğŒ°	maÃ¾a	Ëˆma.Î¸a
ğŒ±ğŒ°ğŒ²ğŒ¼ğƒ	bagms	ËˆbaÉ¡ms
		
ğ„ğ‚ğŒ¹ğŒ¿	triu	ËˆtriuÌ¯
ğŒ°ğŒºğ‚ğŒ°ğŒ½	akran	Ëˆakran
ğƒğŒ´ğŒ¸ğƒ	sÄ“Ã¾s	
ğŒ»ğŒ°ğŒ¿ğ†ğƒ	laufs	ËˆlÉ”Ëfs
ğ…ğŒ°ğŒ¿ğ‚ğ„ğƒ	waurts	ËˆwÉ”rts
		
ğŒ±ğŒ»ğ‰ğŒ¼ğŒ°	blÅma	ËˆbloË.ma
ğŒ·ğŒ°ğ…ğŒ¹	hawi	Ëˆha.wi
ğƒğŒ°ğŒ¹ğŒ»	sail	
ğ†ğŒ¹ğŒ»ğŒ»ğŒ¹	filli	
ğŒ¼ğŒ°ğ„ğƒ	mats	
ğŒ±ğŒ»ğ‰ğŒ¸	blÅÃ¾	
		
		
		
ğŒ·ğŒ°ğŒ¿ğ‚ğŒ½	haurn	
ğ„ğŒ°ğŒ²ğŒ»	tagl	
		
		
ğŒ·ğŒ°ğŒ¿ğŒ±ğŒ¹ğŒ¸	haubiÃ¾	
ğŒ°ğŒ¿ğƒğ‰	ausÅ	
ğŒ°ğŒ¿ğŒ²ğ‰	augÅ	ËˆÉ”ËÉ£oË
		
ğŒ¼ğŒ¿ğŒ½ğŒ¸ğƒ	munÃ¾s	
ğ„ğŒ¿ğŒ½ğŒ¸ğŒ¿ğƒ	tunÃ¾us	
ğ„ğŒ¿ğŒ²ğŒ²ğ‰	tuggÅ	
ğŒ½ğŒ°ğŒ²ğŒ»ğƒ	nagls	
ğ†ğ‰ğ„ğŒ¿ğƒ	fÅtus	
		
ğŒºğŒ½ğŒ¹ğŒ¿	kniu	
ğŒ·ğŒ°ğŒ½ğŒ³ğŒ¿ğƒ	handus	
		
ğ…ğŒ°ğŒ¼ğŒ±ğŒ°	wamba	
		
ğŒ·ğŒ°ğŒ»ğƒ	hals	
		
ğŒ±ğ‚ğŒ¿ğƒğ„ğƒ	brusts	
ğŒ·ğŒ°ğŒ¹ğ‚ğ„ğ‰	hairtÅ	
		
ğŒ³ğ‚ğŒ¹ğŒ²ğŒºğŒ°ğŒ½	drigkan	Ëˆdrin.kan
ğŒ¹ğ„ğŒ°ğŒ½	itan	Ëˆitan
ğŒ±ğŒ´ğŒ¹ğ„ğŒ°ğŒ½	beitan	ËˆbiËtan
		
ğƒğ€ğŒ´ğŒ¹ğ…ğŒ°ğŒ½	speiwan	ËˆspiËwan
		
ğŒ±ğŒ»ğŒ´ğƒğŒ°ğŒ½	blÄ“san	
ğŒ°ğŒ½ğŒ°ğŒ½	anan	
ğŒ·ğŒ»ğŒ°ğŒ·ğŒ¾ğŒ°ğŒ½	hlahjan	
ğƒğŒ°ğŒ¹ğˆğŒ°ğŒ½	saiÆ•an	sÉ›.Êan
ğŒ·ğŒ°ğŒ¿ğƒğŒ¾ğŒ°ğŒ½	hausjan	hÉ”Ës.jan
ğ…ğŒ¹ğ„ğŒ°ğŒ½	witan	Ëˆwitan
ğŒ¸ğŒ°ğŒ²ğŒºğŒ¾ğŒ°ğŒ½	Ã¾agkjan	
		
ğ†ğŒ°ğŒ¿ğ‚ğŒ·ğ„ğŒ¾ğŒ°ğŒ½	faurhtjan	
ğƒğŒ»ğŒ´ğ€ğŒ°ğŒ½	slÄ“pan	
ğŒ»ğŒ¹ğŒ±ğŒ°ğŒ½	liban	
ğŒ³ğŒ°ğŒ¿ğŒ¸ğŒ½ğŒ°ğŒ½	dauÃ¾nan	
ğŒ³ğŒ°ğŒ¿ğŒ¸ğŒ¾ğŒ°ğŒ½	dauÃ¾jan	
		
		
ğƒğŒ»ğŒ°ğŒ·ğŒ°ğŒ½	slahan	
ğƒğŒ½ğŒ´ğŒ¹ğŒ¸ğŒ°ğŒ½	sneiÃ¾an	
		
		
		
ğŒ²ğ‚ğŒ°ğŒ±ğŒ°ğŒ½	graban	ËˆÉ¡raban
		
		
ğŒ²ğŒ°ğŒ²ğŒ²ğŒ°ğŒ½	gaggan	ËˆÉ¡aÅ‹É¡an
ğŒµğŒ¹ğŒ¼ğŒ°ğŒ½	qiman	ËˆkÊ·iman
ğŒ»ğŒ¹ğŒ²ğŒ°ğŒ½	ligan	
ğƒğŒ¹ğ„ğŒ°ğŒ½	sitan	Ëˆsitan
ğƒğ„ğŒ°ğŒ½ğŒ³ğŒ°ğŒ½	standan	Ëˆstandan
ğ…ğŒ°ğŒ½ğŒ³ğŒ¾ğŒ°ğŒ½	wandjan	Ëˆwandjan
ğŒ³ğ‚ğŒ¹ğŒ¿ğƒğŒ°ğŒ½	driusan	ËˆdriuÌ¯.san
ğŒ²ğŒ¹ğŒ±ğŒ°ğŒ½	giban	
ğŒ·ğŒ°ğŒ»ğŒ³ğŒ°ğŒ½	haldan	
		
		
ğŒ¸ğ…ğŒ°ğŒ·ğŒ°ğŒ½	Ã¾wahan	ËˆÎ¸wahan
		
ğ„ğŒ¹ğŒ¿ğŒ·ğŒ°ğŒ½	tiuhan	ËˆtiuÌ¯.han
		
ğ…ğŒ°ğŒ¹ğ‚ğ€ğŒ°ğŒ½	wairpan	
ğŒ±ğŒ¹ğŒ½ğŒ³ğŒ°ğŒ½	bindan	
		
		
ğŒµğŒ¹ğŒ¸ğŒ°ğŒ½	qiÃ¾an	
ğƒğŒ¹ğŒ²ğŒ²ğ…ğŒ°ğŒ½	siggwan	siÅ‹É¡Ê·an
		
		
		
		
		
ğƒğŒ°ğŒ¿ğŒ¹ğŒ»	sauil	ËˆsÉ”Ë.il
ğŒ¼ğŒ´ğŒ½ğŒ°	mÄ“na	ËˆmeË.na
ğƒğ„ğŒ°ğŒ¹ğ‚ğŒ½ğ‰	stairnÅ	ËˆstÉ›r.noË
ğ…ğŒ°ğ„ğ‰	watÅ	
ğ‚ğŒ¹ğŒ²ğŒ½	rign	ËˆriÉ¡n
ğŒ°ğˆğŒ°	aÆ•a	
ğƒğŒ°ğŒ¹ğ…ğƒ	saiws	
ğŒ¼ğŒ°ğ‚ğŒ´ğŒ¹	marei	
ğƒğŒ°ğŒ»ğ„	salt	
ğƒğ„ğŒ°ğŒ¹ğŒ½ğƒ	stains	
		
		
		
ğŒ¼ğŒ¹ğŒ»ğŒ·ğŒ¼ğŒ°	milhma	Ëˆmilh.ma
		
ğŒ·ğŒ¹ğŒ¼ğŒ¹ğŒ½ğƒ	himins	
ğ…ğŒ¹ğŒ½ğŒ³ğƒ	winds	Ëˆwinds
ğƒğŒ½ğŒ°ğŒ¹ğ…ğƒ	snaiws	ËˆsnÉ›Ëws
		
		
ğ†ğ‰ğŒ½	fÅn	ËˆÉ¸oËn
ğŒ°ğŒ¶ğŒ²ğ‰	azgÅ	ËˆazÉ¡oË
ğŒ±ğ‚ğŒ¹ğŒ½ğŒ½ğŒ°ğŒ½	brinnan	Ëˆbrin.nan
ğ…ğŒ¹ğŒ²ğƒ	wigs	
ğ†ğŒ°ğŒ¹ğ‚ğŒ²ğŒ¿ğŒ½ğŒ¹	fairguni	
ğ‚ğŒ°ğŒ¿ğŒ¸ğƒ	rauÃ¾s	
		
		
ğˆğŒ´ğŒ¹ğ„ğƒ	Æ•eits	ÊiËts
ğƒğ…ğŒ°ğ‚ğ„ğƒ	swarts	
ğŒ½ğŒ°ğŒ·ğ„ğƒ	nahts	
ğŒ³ğŒ°ğŒ²ğƒ	dags	daxs
ğŒ¾ğŒ´ğ‚	jÄ“r	
ğ…ğŒ°ğ‚ğŒ¼ğƒ	warms	
ğŒºğŒ°ğŒ»ğŒ³ğƒ	kalds	Ëˆkalds
ğ†ğŒ¿ğŒ»ğŒ»ğƒ	fulls	
ğŒ½ğŒ¹ğŒ¿ğŒ¾ğŒ¹ğƒ	niujis	
ğŒ°ğŒ»ğŒ¸ğŒ´ğŒ¹ğƒ	alÃ¾eis	Ëˆal.Î¸iËs
ğŒ²ğ‰ğŒ¸ğƒ	gÅÃ¾s	É¡oËÎ¸s
ğŒ¿ğŒ±ğŒ¹ğŒ»ğƒ	ubils	
		
		
ğ‚ğŒ°ğŒ¹ğŒ·ğ„ğƒ	raihts	
		
ğˆğŒ°ğƒğƒ	Æ•ass	
		
ğƒğŒ»ğŒ°ğŒ¹ğŒ·ğ„ğƒ	slaihts	
		
ğŒ¸ğŒ°ğŒ¿ğ‚ğƒğŒ¿ğƒ	Ã¾aursus	
ğƒğŒ¿ğŒ½ğŒ¾ğŒ¹ğƒ	sunjis	Ëˆsun.jis
ğŒ½ğŒ´ğˆğŒ°	nÄ“Æ•a	
ğ†ğŒ°ğŒ¹ğ‚ğ‚ğŒ°	fairra	
ğ„ğŒ°ğŒ¹ğŒ·ğƒğ…ğŒ°	taihswa	ËˆtÉ›h.swa
ğŒ·ğŒ»ğŒ´ğŒ¹ğŒ³ğŒ¿ğŒ¼ğŒ°	hleiduma	ËˆhliË.du.ma
ğŒ±ğŒ¹	bi	
ğŒ¹ğŒ½	in	in
ğŒ¼ğŒ¹ğŒ¸	miÃ¾	miÎ¸
ğŒ¾ğŒ°ğŒ·	jah	
ğŒ¾ğŒ°ğŒ±ğŒ°ğŒ¹	jabai	Ëˆja.Î²É›Ë
ğŒ¿ğŒ½ğ„ğŒ´	untÄ“	
ğŒ½ğŒ°ğŒ¼ğ‰	namÅ	Ëˆna.moË