my	my	
ty	ty	
ev	ev	
ny	ny	nɪ
hwi	hwi	ʍiː
i	i	
an	an	
an	an	
omma	omma	
ena	ena	
piw	piw	piˑʊ
pyth	pyth	pɪːθ
ple	ple	
p'eur	p'eur	pøːr
fatel	fatel	ˈfatɛl
ny	ny	nɪ
oll	oll	
lies	lies	
nebes	nebes	
nebes	nebes	
aral	aral	
onan	onan	
dew	dew	
tri	tri	
peswar	peswar	
pymp	pymp	
bras	bras	
hir	hir	
ledan	ledan	
tew	tew	
poos	poos	
bian	bian	
berr	berr	bɛɹ
kul	kul	
moon	moon	
benyn	benyn	
gour	gour	
den	den	dɛːn
flogh	flogh	
gwreg	gwreg	
gour	gour	
mamm	mamm	mæm
tas	tas	taːz
eneval	eneval	
pysk	pysk	pɪːsk
edhen	edhen	
ki	ki	kiː
low	low	
sarf	sarf	
pryv	pryv	
gwedh	gwedh	ɡweːð
koos	koos	
lorgh	lorgh	
frooth	frooth	
has	has	
delen	delen	
gwreydh	gwreydh	
rusk	rusk	
bleujen	bleujen	ˈblœːdʒɛn
gwels	gwels	
lovan	lovan	
kroghen	kroghen	
kig	kig	
goos	goos	ˈɡoːz
askorn	askorn	
blonek	blonek	
oy	oy	ɔˑɪ
korn	korn	
lost	lost	ˈlɔst
pluv	pluv	
blew	blew	
penn	penn	pɛnː
skovarn	skovarn	ˈskɔvarn
lagas	lagas	ˈlaɡas
troen	troen	
ganow	ganow	
dans	dans	dans
taves	taves	
ewyn	ewyn	
troes	troes	
garr	garr	ɡarː
glin	glin	ˈɡliːn
dorn	dorn	
askell	askell	
kroth	kroth	
kolodhyon	kolodhyon	kɔˈlɔðjɔn
konna	konna	
keyn	keyn	
bronn	bronn	
kolon	kolon	
avi	avi	
eva	eva	
dybri	dybri	
densel	densel	ˈdɛnzɛl
sugna	sugna	
berya	berya	
hwyja	hwyja	
hwytha	hwytha	
anella	anella	
hwerthin	hwerthin	
gweles	gweles	
klywes	klywes	
godhvos	godhvos	
prederi	prederi	
blasa	blasa	
own	own	
koska	koska	
bywa	bywa	
merwel	merwel	
ladha	ladha	
omladh	omladh	
helghya	helghya	
gweskel	gweskel	
treghi	treghi	
folsa	folsa	
gwana	gwana	
kravas	kravas	
palas	palas	
neuvya	neuvya	
neyja	neyja	
kerdhes	kerdhes	ˈkɛrðɛs
dos	dos	
gorwedhes	gorwedhes	
esedha	esedha	
sevel	sevel	
treylya	treylya	
koedha	koedha	
ry	ry	
dalghenna	dalghenna	
gwaska	gwaska	
rutya	rutya	
golghi	golghi	
sygha	sygha	
tenna	tenna	
herdhya	herdhya	ˈhɛrðja
tewlel	tewlel	
kelmi	kelmi	
gwrias	gwrias	
akontya	akontya	
leverel	leverel	lɛˈvɛrɛl
kana	kana	
gwari	gwari	
neuvella	neuvella	
bera	bera	
rewi	rewi	
hwythfi	hwythfi	
howl	howl	
loer	loer	
steren	steren	
dowr	dowr	doʊɹ
glaw	glaw	ˈɡla.u
avon	avon	
lynn	lynn	
mor	mor	mɔːr
holan	holan	
karrek	karrek	
tewes	tewes	
doust	doust	
dor	dor	
kommol	kommol	
niwl	niwl	
ebron	ebron	
gwyns	gwyns	
ergh	ergh	
rew	rew	
mog	mog	
tan	tan	
lusow	lusow	
leski	leski	
fordh	fordh	fɔrð
menydh	menydh	
rudh	rudh	ryːð
glas	glas	ɡlaːz
melyn	melyn	ˈmɛlɪn
gwynn	gwynn	ɡwɪnː
du	du	dyː
nos	nos	
dydh	dydh	dɪːð
blydhen	blydhen	
toemm	toemm	
yeyn	yeyn	
leun	leun	
nowydh	nowydh	
hen	hen	
da	da	
drog	drog	
breyn	breyn	
plos	plos	
ewn	ewn	
krenn	krenn	
lymm	lymm	
sogh	sogh	
gwastas	gwastas	
glyb	glyb	ɡlɪːb
sygh	sygh	
ewn	ewn	
ogas	ogas	
pell	pell	
deghow	deghow	
kledh	kledh	
orth	orth	
yn	yn	ɪn
gans	gans	
ha	ha	
mar	mar	
drefenn	drefenn	
hanow	hanow	