mee	mee	miː
oo	oo	u
eh	eh	
shin	shin	
shiu	shiu	
ad	ad	
yn	yn	
yn	yn	
shoh	shoh	
shen	shen	ʃɛᵈn
quoi	quoi	
c'red	c'red	
c'raad	c'raad	
traa	traa	
aght	aght	
cha	cha	
ooilley	ooilley	
mooarane	mooarane	
ennagh	ennagh	
beggan	beggan	
elley	elley	
un	un	eːn
daa	daa	d̪eː
tree	tree	t̪riː
kiare	kiare	kʲeːə(r)
queig	queig	kwɛɡ
mooar	mooar	muːr
foddey	foddey	
lhean	lhean	
roauyr	roauyr	
trome	trome	t̪roːm
beg	beg	
giare	giare	
coon	coon	
thanney	thanney	
ben	ben	bɛᵈn
dooinney	dooinney	ˈd̪uːnʲə
dooinney	dooinney	ˈd̪uːnʲə
lhiannoo	lhiannoo	
ben	ben	bɛᵈn
dooinney	dooinney	ˈd̪uːnʲə
moir	moir	maːɹ
ayr	ayr	ˈeːar
baagh	baagh	
eeast	eeast	jiːst
ushag	ushag	ˈoʒaɡ
coo	coo	
meeyl	meeyl	miːl
aarnieu	aarnieu	
beisht	beisht	beːʃt͡ʃ
billey	billey	ˈbilʲə
keyll	keyll	kiːlʲ
maidjey	maidjey	ˈmaːʒə
mess	mess	meːs
rass	rass	raːs
duillag	duillag	ˈd̪olʲaɡ
fraue	fraue	freːw
roost	roost	ruːs
blaa	blaa	bleː
faiyr	faiyr	feːə
tead	tead	t̪ed̪
crackan	crackan	ˈkraːɣən
feill	feill	feːlʲ
fuill	fuill	folʲ
craue	craue	kreːw
blennick	blennick	ˈblɛnɪk
ooh	ooh	au
corn	corn	
arbyl	arbyl	
clooie	clooie	
folt	folt	folt̪
kione	kione	caun
cleaysh	cleaysh	kleːʃ
sooill	sooill	suːlʲ
stroin	stroin	st̪rudʲnʲ
beeal	beeal	ˈbiəl
feeackle	feeackle	ˈfiːɣəl
çhengey	çhengey	ˈtʃɛnʲə
ingin	ingin	ˈiŋən
cass	cass	kaːs
cass	cass	kaːs
glioon	glioon	ɡlʲuːnʲ
laue	laue	leːw
fedjag	fedjag	ˈfaiaɡ
bolg	bolg	bolɡ
collane	collane	
mwannal	mwannal	ˈmonal
dreeym	dreeym	d̪riːm
keeagh	keeagh	kiːx
cree	cree	kriː
aane	aane	eːn
iu	iu	
ee	ee	iː
greim	greim	
jiole	jiole	
shelley	shelley	
skeeah	skeeah	
sheid	sheid	
ennal	ennal	
gear	gear	
faik	faik	
clasht	clasht	
ec	ec	ɛɟ
smooinee	smooinee	
soar	soar	
aggle	aggle	
caddil	caddil	ˈkaːðəl
bio	bio	blʲoː
baase	baase	
marr	marr	
cagg	cagg	kaːɡ
shelg	shelg	
bwoaill	bwoaill	
giar	giar	
scolt	scolt	
seiy	seiy	
screeb	screeb	
cleigh	cleigh	
snaue	snaue	
etlee	etlee	
shooyl	shooyl	ʃuːlʲ
tar	tar	
lhie	lhie	laj
soie	soie	
shass	shass	
cass	cass	kaːs
tuitt	tuitt	t̪utʲ
cur	cur	
cum	cum	
çhionn	çhionn	
rub	rub	
niee	niee	
glen	glen	ɡlɛn
tayrn	tayrn	
broo	broo	
ceau	ceau	cæu
kiangle	kiangle	
fuaill	fuaill	
coont	coont	
abbyr	abbyr	
arrane	arrane	
cloie	cloie	klɛi
snaue	snaue	
freayne	freayne	
rio	rio	
att	att	
grian	grian	ɡriːn
eayst	eayst	eːs
rollage	rollage	roˈleːɡ
ushtey	ushtey	ˈuʃtʲə
fliaghey	fliaghey	flʲaː
awin	awin	aunʲ
lhingey	lhingey	
faarkey	faarkey	ˈføːɹkə
sollan	sollan	ˈsolan
clagh	clagh	klaːx
geinnagh	geinnagh	ˈɡʲanʲax
joan	joan	dʒaun
thalloo	thalloo	ˈtɔlu
bodjal	bodjal	
kay	kay	kʲeː
aer	aer	eːə
geay	geay	ɡiː
sniaghtey	sniaghtey	ˈʃnʲaxt̪ə
rio	rio	
jaagh	jaagh	ˈd͡ʒeːax
aile	aile	ail
leoie	leoie	løi
losht	losht	
bayr	bayr	
beinn	beinn	
jiarg	jiarg	
eayney	eayney	
buigh	buigh	
bane	bane	
doo	doo	
oie	oie	ɛi
laa	laa	leː
blein	blein	blʲeːnʲ
çheh	çheh	
feayr	feayr	
lane	lane	lɛdn
noa	noa	noː
shenn	shenn	
mie	mie	maɪ
drogh	drogh	
breinn	breinn	
breinnagh	breinnagh	
jeeragh	jeeragh	ˈd͡ʒiːrax
cruinn	cruinn	
geyre	geyre	
moal	moal	
meein	meein	
fliugh	fliugh	
çhirrym	çhirrym	
kiart	kiart	
çheu	çheu	
foddey	foddey	
jesh	jesh	
clee	clee	
ec	ec	ɛɟ
ayns	ayns	
lesh	lesh	
as	as	
ga	ga	
er-yn-oyr	er-yn-oyr	
ennym	ennym	ˈenəm