náya	náya	
jay	jay	
ja	ja	
jo	jo	
jey	jey	
je	je	
jlu	jlu	
		
tzalú	tzalú	
		
al	al	
ti’	ti’	
ja’	ja’	
jtoo	jtoo	
		
		
		
nim	nim	
		
		
		
jun	jun	
káb’a	káb’a	
óxa	óxa	
chája	chája	
jwe’	jwe’	
matí’j	matí’j	
nmak	nmak	
la’n	la’n	
cho’t	cho’t	
-	-	
ch’in	ch’in	
ch’in twe’	ch’in twe’	
ch’in twitz	ch’in twitz	
xaxj	xaxj	
xuj	xuj	
xínak	xínak	
xjaal	xjaal	
al	al	
xu’l	xu’l	
chmil	chmil	
txu	txu	
man	man	
alamáj	alamáj	
kixh	kixh	
ch’it	ch’it	
txya’n	txya’n	
squk’	squk’	
lb’aj	lb’aj	
		
tze’	tze’	
txhik’úul	txhik’úul	
		
lo’pj	lo’pj	
íyaj	íyaj	
txaq	txaq	
		
		
ab’éch	ab’éch	
ch’im	ch’im	
chjaj	chjaj	
tz’úmal	tz’úmal	
chi’pj	chi’pj	
chik’y	chik’y	
b’aaq	b’aaq	
		
jos	jos	
		
		
		
tzmal	tzmal	
wi’	wi’	
xkin	xkin	
tb’a’	tb’a’	
txánb’aj	txánb’aj	
tzi	tzi	
witx	witx	
aq’	aq’	
		
		
		
ch’ek	ch’ek	
q’ab’	q’ab’	
		
k’u’j	k’u’j	
		
		
xyop	xyop	
		
ánm	ánm	
		
k’an	k’an	
waa’n	waa’n	
		
		
		
		
		
		
		
		
b’i’n	b’i’n	
alón	alón	
		
		
xob’	xob’	
		
najl	najl	
chim	chim	
		
		
		
		
		
		
		
		
		
		
		
		
		
		
		
		
		
		
		
		
		
		
		
		
		
		
		
		
		
		
		
		
		
		
		
		
		
q’ij	q’ij	
xjaaw	xjaaw	
che’w	che’w	
a’	a’	
jb’aal	jb’aal	
nim a’	nim a’	
		
		
á’tz’a	á’tz’a	
xaq	xaq	
		
quq	quq	
tx’otx’	tx’otx’	
muuj	muuj	
		
kya’j	kya’j	
chq’iq’	chq’iq’	
		
		
sib’	sib’	
q’a’q	q’a’q	
tza’j	tza’j	
pátan	pátan	
b’e	b’e	
witz	witz	
kyaq	kyaq	
cha’x	cha’x	
sak q’ent	sak q’ent	
sak	sak	
q’eq’	q’eq’	
qoníya	qoníya	
q’ijl	q’ijl	
jnab’q’í	jnab’q’í	
métmaj	métmaj	
che’w	che’w	
noj	noj	
ák’aj	ák’aj	
q’ának	q’ának	
b’a’n	b’a’n	
k’a’	k’a’	
		
		
		
		
		
		
		
		
		
		
naká	naká	
naqch	naqch	
		
		
		
		
		
		
ka	ka	
		
b’i	b’i	