laa’in	laa’in	
laa’at	laa’at	
ha’an	ha’an	
laa’o	laa’o	
laa’ex	laa’ex	
eb’	eb’	
ha'in	ha'in	
wan le'	wan le'	
arin	arin	
le'	le'	
ani	ani	
k’a’	k’a’	
b'ar	b'ar	
joq'e	joq'e	
chan ru	chan ru	
ink'a'	ink'a'	
anchal	anchal	
k'i	k'i	
junaq	junaq	
kach’in	kach’in	
jalan	jalan	
jun	jun	
ka'ib'	ka'ib'	
oxib'	oxib'	
kaahib'	kaahib'	
oob'	oob'	
nim	nim	
nim xkelam	nim xkelam	
nim ru	nim ru	
nim xsa'	nim xsa'	
aal	aal	
kok’	kok’	
tupus roq	tupus roq	
kok' ru	kok' ru	
b'aq	b'aq	
ixq	ixq	
teelom	teelom	
winq	winq	
al	al	
ixaqil	ixaqil	
b’eelom	b’eelom	
na’	na’	
taat	taat	
xul	xul	
kar	kar	
tz’ik	tz’ik	
tz’i’	tz’i’	
uk'	uk'	
k’anti’	k’anti’	
kuluk	kuluk	
che’	che’	
k’iche’	k’iche’	
ruq' che'	ruq' che'	
u	u	
iyaj	iyaj	
xaq	xaq	
xe’	xe’	
rix che	rix che	
uutz'u'uj	uutz'u'uj	
pach'aya'	pach'aya'	
k’aam	k’aam	
tz’uumal	tz’uumal	
tib’	tib’	
kik’	kik’	
b’aq	b’aq	
manteek	manteek	
mol	mol	
xukub'	xukub'	
ye	ye	
rismal xul	rismal xul	
ismal	ismal	
jolom	jolom	
xik	xik	
		
u’uj	u’uj	
e	e	
e	e	
ru'uj aq'	ru'uj aq'	
ixi’ij	ixi’ij	
oq	oq	
a’	a’	
aq	aq	
uq’m	uq’m	
xik’	xik’	
sa’	sa’	
k'amk'ot	k'amk'ot	
kux	kux	
ix	ix	
tu’	tu’	
ch'ool	ch'ool	
ch'och'	ch'och'	
uk'ak	uk'ak	
tzakank	tzakank	
qachok	qachok	
tz'ub'uk	tz'ub'uk	
chuub'ak	chuub'ak	
xa'wak	xa'wak	
apuunk	apuunk	
musiq'ak	musiq'ak	
se'ek	se'ek	
ilok	ilok	
ab'ink	ab'ink	
nawink	nawink	
k'a'uxlak	k'a'uxlak	
utz’uk	utz’uk	
xiw	xiw	
wark	wark	
na'ajink	na'ajink	
kamk	kamk	
kamsink	kamsink	
ch'e'ok	ch'e'ok	
yohob'k	yohob'k	
b'ujuk	b'ujuk	
kuruk	kuruk	
kiib'ank	kiib'ank	
xeq'ok	xeq'ok	
q'oyok	q'oyok	
pikok	pikok	
numxik	numxik	
rupik	rupik	
b’eek	b’eek	
chalk	chalk	
sotlaak	sotlaak	
chunlaak	chunlaak	
xaqliik	xaqliik	
b’alq’usink	b’alq’usink	
soq'e'k	soq'e'k	
k'ehok	k'ehok	
q’unuk	q’unuk	
pitz’ok	pitz’ok	
jilok	jilok	
ch'ajok	ch'ajok	
mesok	mesok	
jukunk	jukunk	
minok	minok	
pumuk	pumuk	
b'ak’ok	b'ak’ok	
b'ojok	b'ojok	
ajlank	ajlank	
yehok	yehok	
b'ichank	b'ichank	
b’atz’unk	b’atz’unk	
pamamnak	pamamnak	
yo i roq	yo i roq	
keho'k	keho'k	
siip	siip	
saq’e	saq’e	
po	po	
chahim	chahim	
ha’	ha’	
hab’	hab’	
nima’	nima’	
palaw	palaw	
palaw	palaw	
atz'am	atz'am	
pek	pek	
samahi’	samahi’	
poqs	poqs	
ch’och’	ch’och’	
choq	choq	
sujew	sujew	
choxa	choxa	
iq’	iq’	
xchu’i keh	xchu’i keh	
ke	ke	
sib’	sib’	
xam	xam	
cha	cha	
k’at	k’at	
b'e	b'e	
tzuul	tzuul	
kaq	kaq	
rax	rax	
q'an	q'an	
saq	saq	
q'eq	q'eq	
q'ojyin	q'ojyin	
kutank	kutank	
hab’	hab’	
tiq	tiq	
ke	ke	
nujenaq	nujenaq	
ak’	ak’	
q'eel	q'eel	
us	us	
lab'	lab'	
q'aaneq	q'aaneq	
b'alak'	b'alak'	
tiik	tiik	
kotko	kotko	
q'es	q'es	
room	room	
q'un	q'un	
t'aqt'aq	t'aqt'aq	
chaqi	chaqi	
q'axal chaab'il	q'axal chaab'il	
nach'	nach'	
nach'	nach'	
sa' nim	sa' nim	
tz'e	tz'e	
sa’	sa’	
sa’	sa’	
rik’in	rik’in	
ut	ut	
si'	si'	
xb’aan naq	xb’aan naq	
k'ab'a'ej	k'ab'a'ej	