ja	ja	
un	un	
ne	ne	
mi	mi	
ma	ma	
wey	wey	
guté	guté	
te	te	
akhó	akhó	
to	to	
men	men	
bo	bo	
aney	aney	
basha	basha	
bolotom	bolotom	
be	be	
saoh	saoh	
bot	bot	
markaam	markaam	
fookan	fookan	
yata	yata	
hen	hen	
altán	altán	
iské	iské	
wáltu	wáltu	
cendó	cendó	
uyúm	uyúm	
ghosanom	ghosanom	
shoqom	shoqom	
shoqom	shoqom	
czolom	czolom	
echoghon	echoghon	
gaganom	gaganom	
glinom	glinom	
beyenom	beyenom	
gus	gus	
hir	hir	
ses	ses	
heles	heles	
gos	gos	
oyohar	oyohar	
nani	nani	
tati	tati	
hoyes	hoyes	
chúmu	chúmu	
czen	czen	
huk	huk	
ha	ha	
toll	toll	
ghalgho	ghalgho	
nosh	nosh	
jangle	jangle	
kona	kona	
mewa	mewa	
ghono	ghono	
tap	tap	
czeres	czeres	
szar	szar	
asqúr	asqúr	
shiqá	shiqá	
tete	tete	
bat	bat	
chap	chap	
moltan	moltan	
ten	ten	
bes	bes	
tuma	tuma	
torr	torr	
shilan	shilan	
folgho	folgho	
bur	bur	
yates	yates	
tomal	tomal	
elchi	elchi	
mosh	mosh	
khat	khat	
mey	mey	
yomos	yomos	
ooro	ooro	
hotes	hotes	
tang	tang	
onongos	onongos	
ren	ren	
galgi	galgi	
ool	ool	
cher	cher	
ess	ess	
waldes	waldes	
odel	odel	
os	os	
eken	eken	
men	men	
sechom	sechom	
gatichom	gatichom	
choos	choos	
thoo	thoo	
oqq	oqq	
phoolchom	phoolchom	
hesz	hesz	
ghasichom	ghasichom	
yeshom	yeshom	
dokoyal	dokoyal	
heyom	heyom	
donesh	donesh	
szoong	szoong	
gomalchom	gomalchom	
gochachom	gochachom	
jee	jee	
yorchom	yorchom	
esqayom	esqayom	
dohom	dohom	
dast	dast	
dechom	dechom	
katar	katar	
tapari	tapari	
		
khaworchom	khaworchom	
birqaayom	birqaayom	
miniyachom	miniyachom	
dowalchom	dowalchom	
goczarchom	goczarchom	
chorom	chorom	
faing echom	faing echom	
horoshom	horoshom	
deye chom	deye chom	
ewalrarkichom	ewalrarkichom	
walchom	walchom	
oochom	oochom	
dohoyom	dohoyom	
		
czagham	czagham	
hal chom	hal chom	
khas echom	khas echom	
tash chom	tash chom	
thank echom	thank echom	
lip echom	lip echom	
gat echom	gat echom	
czapa yom	czapa yom	
yawochom	yawochom	
gharing echom	gharing echom	
see'm	see'm	
girashom	girashom	
		
hor chom	hor chom	
guma mayum	guma mayum	
do hoqichom	do hoqichom	
sa	sa	
halanz	halanz	
asomoon	asomoon	
cel	cel	
diyaarchom	diyaarchom	
sendey	sendey	
phari	phari	
samandar	samandar	
bayoo	bayoo	
dan	dan	
sawo	sawo	
gert	gert	
tik	tik	
haralt	haralt	
khorong	khorong	
ayash	ayash	
tish	tish	
giye	giye	
ghamo	ghamo	
thas	thas	
fooh	fooh	
qon	qon	
gholchom	gholchom	
gan	gan	
char	char	
bardom	bardom	
toq	toq	
eskaark	eskaark	
borom	borom	
matoom	matoom	
thap	thap	
gunc	gunc	
den	den	
garom	garom	
chaghúrum	chaghúrum	
bir	bir	
thosh	thosh	
mayen	mayen	
daltás	daltás	
shom	shom	
ghasom	ghasom	
therkit	therkit	
czan	czan	
larokores	larokores	
thakthak	thakthak	
fat	fat	
sheghesom	sheghesom	
zah	zah	
boyam	boyam	
		
asoor	asoor	
mathan	mathan	
domo	domo	
ghamo	ghamo	
-ce	-ce	
-chi	-chi	
kaat	kaat	
ka	ka	
		
bota siya	bota siya	
yek	yek	