ğŒŒğŒ‰	mi	mi
ğŒ…ğŒ	vn	
ğŒ€ğŒ	an	
ğŒŒğŒ‰ğŒ“	mir	
		
ğŒ„ğŒ‰ğŒ	ein	
ğŒ‚ğŒ€	ca	
ğŒ‚ğŒ€	ca	
ğŒˆğŒ…ğŒ‰	Î¸vi	
		
		
		
		
		
ğŒ‰ğŒ‚	ic	
ğŒ„ğŒ‰ğŒ	ein	
ğŒ‡ğŒ„ğŒ…ğŒ€	heva	
		
		
		
		
ğŒˆğŒ–	Î¸u	tÊ°u
ğŒ†ğŒ€ğŒ‹	zal	tÍ¡sal
ğŒ‚ğŒ‰	ci	ki
ğŒ‘ğŒ€	Å›a	Êƒa
ğŒŒğŒ€ğŒ™	maÏ‡	makÊ°
		
		
		
		
		
		
		
		
		
ğŒğŒ…ğŒ‰ğŒ€	pvia	
		
		
ğŒ‡ğŒ…ğŒ”	hvs	
ğŒğŒ…ğŒ‰ğŒ€	pvia	
		
ğŒ€ğŒ•ğŒ‰	ati	ËˆÉ‘tÉª
ğŒ€ğŒğŒ€	apa	ËˆÉ‘pÉ™
ğŒ†ğŒ…ğŒ”ğŒ‹ğŒ„	zvsle	
		
		
		
		
		
		
		
		
		
		
		
		
		
		
		
		
		
		
		
		
		
		
		
		
		
		
		
		
		
		
		
		
		
		
		
		
		
		
		
		
		
		
		
		
		
		
		
ğŒ”ğŒğŒ„ğŒ•	spet	
		
		
		
		
		
		
		
		
ğŒ•ğŒ„ğŒ…	tev	
		
		
		
		
		
		
ğŒ”ğŒ…ğŒ€ğŒ‹	sval	
ğŒ‹ğŒ„ğŒ‰ğŒ	lein	
		
		
		
		
		
		
		
		
		
		
		
		
		
		
		
		
		
		
ğŒ€ğŒ‹	al	
		
		
		
		
		
		
ğŒ€ğŒ“ğŒ”	ars	
ğŒ•ğŒ“ğŒ…ğŒˆ	trvÎ¸	
		
		
		
		
		
		
		
		
		
		
ğŒ…ğŒ”ğŒ‰ğŒ‹	vsil	
ğŒ•ğŒ‰ğŒ…	tiv	
ğŒğŒ…ğŒ‹ğŒ…ğŒŒ	pvlvm	
ğŒğŒ„ğŒ“ğŒ‰	neri	ËˆneÉ¾Éª
		
		
		
		
		
ğŒğŒ„ğŒğŒˆğŒ…ğŒğŒ€	penÎ¸vna	
		
		
ğŒ‚ğŒ„ğŒ‹	cel	
		
		
ğŒšğŒ€ğŒ‹ğŒ€ğŒ•ğŒ…	falatv	
		
		
		
		
ğŒ…ğŒ„ğŒ“ğŒ”	vers	
		
		
ğŒ•ğŒ„ğŒ†ğŒ€ğŒ	tezan	
		
		
		
		
		
		
		
ğŒ•ğŒ‰ğŒ	tin	
ğŒ€ğŒ…ğŒ‰ğŒ‹	avil	ËˆÉ‘wÉªl
		
		
		
		
		
ğŒŒğŒ‹ğŒ€ğŒ‚ğŒ€	mlaca	
		
		
		
		
		
		
		
		
		
		
		
		
		
ğŒ‡ğŒ€ğŒŒğŒ˜ğŒ€	hamÏ†a	
ğŒ‹ğŒ€ğŒ‰ğŒ…ğŒ€	laiva	
		
ğŒˆğŒ…ğŒ‰	Î¸vi	
		
-ğŒ‚	-c	
		
ğŒğŒ€ğŒ‚	nac	
		