ĝae	ĝae	
zae	zae	
ane	ane	
menden	menden	
menzen	menzen	
anene	anene	
nen	nen	
re	re	
gu'e	gu'e	
gure	gure	
aba	aba	
ana	ana	
mea	mea	
menam	menam	
anagin	anagin	
nu	nu	
du	du	
i'iz	i'iz	
		
		
balare	balare	
aš	aš	
min	min	
eš	eš	
limmu	limmu	
ya	ya	
gal	gal	
sud4	sud4	
peš	peš	
kul	kul	
dugud	dugud	
gi17	gi17	
gud8	gud8	
sig	sig	
gi17	gi17	
mu10	mu10	
na	na	
erim	erim	
dumu	dumu	
dam	dam	
dam	dam	
ama	ama	
ada	ada	
ning-úr-limmu	ning-úr-limmu	
ku6	ku6	
mušen	mušen	
ur	ur	
uh3	uh3	
muš	muš	
mar	mar	
ngiš	ngiš	
tir	tir	
ngiš	ngiš	
gurun	gurun	
a	a	
		
		
		
ul	ul	
ú	ú	
éše	éše	
su	su	
uzu	uzu	
úš	úš	
		
ìa	ìa	
nuz	nuz	
si	si	
kun	kun	
		
siki	siki	
sang	sang	
ngeštug	ngeštug	
igi	igi	
kiri3	kiri3	
ka	ka	
zu	zu	
eme	eme	
umbin	umbin	
ngìri	ngìri	
pah	pah	
		
buzur	buzur	
		
		
šag4	šag4	
gú	gú	
háš	háš	
gaba	gaba	
ur5HAR	ur5HAR	
bà	bà	
nang	nang	
gu7	gu7	
zú-gub	zú-gub	
sub	sub	
zug4	zug4	
buru8	buru8	
ru	ru	
zi	zi	
išiš2	išiš2	
igi	igi	
ngeštug	ngeštug	
zu	zu	
ngeštug	ngeštug	
hab2	hab2	
ní	ní	
ù	ù	
sig7	sig7	
ug4	ug4	
ug4	ug4	
du14	du14	
taka	taka	
ra	ra	
kud	kud	
dar	dar	
ra	ra	
hur	hur	
bal	bal	
		
dal	dal	
du	du	
du	du	
ku	ku	
suš	suš	
gub	gub	
gur	gur	
šub	šub	
ba	ba	
da	da	
hir	hir	
sub	sub	
tu5	tu5	
sub	sub	
rig	rig	
taka	taka	
ri	ri	
dab2	dab2	
		
šita5	šita5	
ég	ég	
mud6	mud6	
ešemen2	ešemen2	
dirig	dirig	
zal	zal	
halba2	halba2	
mah	mah	
ud	ud	
iti	iti	
ul	ul	
a	a	
im	im	
id	id	
ab	ab	
ab	ab	
mun	mun	
na4	na4	
sahar	sahar	
ukum	ukum	
ki	ki	
imi	imi	
muru9	muru9	
an	an	
líl	líl	
šeg	šeg	
šeg8	šeg8	
i-bí	i-bí	
izi	izi	
dé	dé	
tab	tab	
a-rá	a-rá	
kur	kur	
sa-sa	sa-sa	
sig7	sig7	
sig7	sig7	
kug	kug	
gíg	gíg	
ngi6	ngi6	
u4	u4	
mu	mu	
kúm	kúm	
ten	ten	
éšša	éšša	
gibil	gibil	
ul	ul	
dùg	dùg	
hul	hul	
hab2	hab2	
pe-el-lá	pe-el-lá	
		
ninda	ninda	
		
		
		
lah	lah	
háda	háda	
gi-na	gi-na	
da	da	
ta	ta	
zi-da	zi-da	
gùb-bu	gùb-bu	
da	da	
a	a	
		
ga	ga	
		
mu	mu	
mu	mu	