ho'	ho'	
to'	to'	
-	-	
hon	hon	
ton	ton	
-	-	
		
		
		
		
		
		
		
		
		
		
		
		
		
		
		
dobinde	dobinde	
kwili	kwili	
ha'i	ha'i	
a:wide	a:wide	
apde	apde	
		
		
		
		
		
ts'ana	ts'ana	
		
		
		
okya	okya	
ottsi	ottsi	
shiwi	shiwi	
chawe	chawe	
		
		
tsitda	tsitda	
datchu	datchu	
		
k'yashhida	k'yashhida	
		
wattsida	wattsida	
me'le	me'le	
ayaso'a	ayaso'a	
wi'le	wi'le	
datdanne	datdanne	
		
łamme	łamme	
		
		
hawe	hawe	
		
		
		
		
do'ninne	do'ninne	
		
shiwe	shiwe	
ade	ade	
samme	samme	
		
doko:ko mo'le	doko:ko mo'le	
		
		
		
daya:we	daya:we	
oshokkwinne	oshokkwinne	
lashokdine	lashokdine	
dunanne	dunanne	
no'linne	no'linne	
awadine	awadine	
o'nanne	o'nanne	
honninne	honninne	
		
wekwinne	wekwinne	
sakwinne	sakwinne	
		
asinne	asinne	
		
		
		
k'isinne	k'isinne	
		
		
ik'e:nanne	ik'e:nanne	
		
		
		
		
		
		
		
		
		
		
		
		
		
		
		
		
		
		
		
		
		
		
		
		
		
		
		
		
		
		
		
		
		
		
		
		
		
		
		
		
		
		
		
		
		
		
		
		
		
		
		
		
		
		
		
		
yadokkya	yadokkya	
yachunne	yachunne	
mo'yachunne	mo'yachunne	
k'yawe	k'yawe	
lidokkya	lidokkya	
k'yawinanne	k'yawinanne	
k'yananne	k'yananne	
		
ma:k'ose	ma:k'ose	
a'le	a'le	
sowe	sowe	
		
ulohnanne	ulohnanne	
lo'le lonanne	lo'le lonanne	
		
a'bo'yanne	a'bo'yanne	
binnakkya	binnakkya	
		
		
		
aklinne	aklinne	
		
		
		
yalanne	yalanne	
shilowa	shilowa	
ashena	ashena	
łupts'inna	łupts'inna	
k'ohanna	k'ohanna	
k'winna	k'winna	
dehłaba	dehłaba	
yadonne	yadonne	
debikwayinanne	debikwayinanne	
		
		
		
		
		
		
		
		
		
		
		
		
		
		
		
		
		
		
		
		
		
		
		
		
		
		
		
		