ndi-	ndi-	
iwe	iwe	ˈi.we
a	a	
ife	ife	ˈi.fe
inu	inu	ˈi.nu
iwo	iwo	ˈi.wó
uyu	uyu	
uyo	uyo	
pano	pano	
apo	apo	
amene	amene	
		
mmene	mmene	
pamene	pamene	
-nji	-nji	
si	si	
-nse	-nse	
-mbiri	-mbiri	
-ngapo	-ngapo	
-ena	-ena	
-ina	-ina	
chimodzi	chimodzi	
ziwiri	ziwiri	
zitatu	zitatu	
zinai	zinai	
zisanu	zisanu	
-kulu	-kulu	
-tali	-tali	
-takata	-takata	
-khathamira	-khathamira	
-lemera	-lemera	
-ng’ono	-ng’ono	
-fupi	-fupi	
-chepetsa	-chepetsa	
-pyapyala	-pyapyala	
mkazi	mkazi	ˈmká.zi
mwamuna	mwamuna	
munthu	munthu	ˈmu.ⁿtʰu
mwana	mwana	ˈmʷa.ná
mkazi	mkazi	ˈmká.zi
munthu	munthu	ˈmu.ⁿtʰu
mayi	mayi	ˈmá.ji
tate	tate	ˈta.té
nyama	nyama	ˈɲa.ma
nsomba	nsomba	ˈⁿsó.ᵐba
mbalame	mbalame	ᵐbáˈɽa.me
galu	galu	ˈɡa.ɽú
nsabwe	nsabwe	ˈⁿsa.ɓʷe
njoka	njoka	ˈⁿd͡ʒó.ka
nyongolotsi	nyongolotsi	
mtengo	mtengo	mˈté.ᵑɡo
nkhalango	nkhalango	
ndodo	ndodo	
chipatso	chipatso	t͡ʃiˈpá.t͡so
mbewu	mbewu	ˈᵐbé.(w)u
tsamba	tsamba	ˈt͡sa.ᵐba
muzu	muzu	ˈmu.zu
kowola	kowola	
duwa	duwa	ˈɗu.(w)a
udzu	udzu	ˈu.d͡zú
chingwe	chingwe	
khungu	khungu	ˈkʰu.ᵑɡú
nyama	nyama	ˈɲa.ma
magazi	magazi	maˈɡa.zi
fupa	fupa	ˈfú.pa
mafuta	mafuta	maˈfú.ta
dzira	dzira	ˈd͡zi.ɽa
nyanga	nyanga	
mchira	mchira	ˈmt͡ʃí.ɽa
nthenga	nthenga	ˈⁿtʰe.ᵑɡa
tsitsi	tsitsi	
mutu	mutu	ˈmu.tú
khutu	khutu	ˈkʰu.tú
diso	diso	ˈɗí.so
mphuno	mphuno	ˈᵐpʰu.no
kamwa	kamwa	ˈka.mʷa
dzino	dzino	ˈd͡zí.no
lilime	lilime	ɽiˈɽí.me
chikhadabo	chikhadabo	
phazi	phazi	ˈpʰa.zí
mwendo	mwendo	ˈmʷe.ⁿdo
bondo	bondo	ˈɓó.ⁿdo
dzanja	dzanja	ˈd͡za.ⁿd͡ʒa
khupe	khupe	
mimba	mimba	ˈmí.ᵐba
		
khosi	khosi	ˈkʰo.si
msana	msana	mˈsá.na
bere	bere	ˈɓé.ɽe
mtima	mtima	mˈtí.ma
chiwindi	chiwindi	t͡ʃíˈw⁽ᵝ⁾i.ⁿdi
kumwa	kumwa	
-dya	-dya	
-kuluma	-kuluma	
-yamwa	-yamwa	
-mate	-mate	
-sanzi	-sanzi	
-omba	-omba	
-puma	-puma	
-seka	-seka	
-wona	-wona	
-mva	-mva	
-dziwa	-dziwa	
-ganiza	-ganiza	
-nunkha	-nunkha	
-opa	-opa	
-gona	-gona	
-khala	-khala	
-fa	-fa	
-pha	-pha	
ndewu	ndewu	
-saka	-saka	
		
-duka	-duka	
-balula	-balula	
-baya	-baya	
-kalasa	-kalasa	
-mba	-mba	
-sambila	-sambila	
-nonthoka	-nonthoka	
-yenda	-yenda	
-dza	-dza	
-gona	-gona	
-tambalala	-tambalala	
-yima	-yima	
-khota	-khota	
-gwa	-gwa	
-patsa	-patsa	
-wetsa	-wetsa	
-khwinyata	-khwinyata	
-fikisa	-fikisa	
-samba	-samba	
-khula	-khula	
-koka	-koka	
-kankha	-kankha	
-ponya	-ponya	
-kadzira	-kadzira	
-soka	-soka	
-werenga	-werenga	
		
-yimba	-yimba	
-doda	-doda	
-beruka	-beruka	
-yenda	-yenda	
		
-fufuma	-fufuma	
dzuwa	dzuwa	ˈd͡zú.w⁽ᵝ⁾a
mwezi	mwezi	ˈmʷe.zí
nyenyezi	nyenyezi	ɲéˈɲe.zí
madzi	madzi	ˈma.d͡zí
mvula	mvula	ˈᶬvú.ɽa
mtsinje	mtsinje	mˈt͡sí.ⁿd͡ʒe
nyanja	nyanja	ˈɲa.ⁿd͡ʒá
nyanja ya mchere	nyanja ya mchere	
muthira mchere	muthira mchere	
mwala	mwala	ˈmʷa.ɽá
mchenga	mchenga	mˈt͡ʃe.ᵑɡa
fumbi	fumbi	ˈfu.ᵐbí
dziko	dziko	ˈd͡zí.ko
mtambo	mtambo	mˈta.ᵐbo
nkhungu	nkhungu	ˈᵑkʰú.ᵑɡu
thambo	thambo	
chiphwisa	chiphwisa	
madzi oundana oyera amaoneka pamwamba pa mapiri aatali ku mayiko ozizira	madzi oundana oyera amaoneka pamwamba pa mapiri aatali ku mayiko ozizira	
madzi oundana	madzi oundana	
utsi	utsi	ˈu.t͡sí
moto	moto	ˈmó.to
chipala	chipala	t͡ʃiˈpa.ɽa
-wocha	-wocha	
msewu	msewu	mˈse.(w)u
phiri	phiri	ˈpʰi.ɽi
-fiira	-fiira	
-biriwira	-biriwira	
-chikasu	-chikasu	
-yera	-yera	
mkuda	mkuda	
usiku	usiku	
tsiku	tsiku	ˈt͡sí.ku
chaka	chaka	ˈt͡ʃa.ká
-funda	-funda	
-zizira	-zizira	
-khuta	-khuta	
-tsopano	-tsopano	
-kalamba	-kalamba	
-bwino	-bwino	
-ipa	-ipa	
-ola	-ola	
-da	-da	
-ongoka	-ongoka	
-zungulira	-zungulira	
-thwa	-thwa	
-phinjika	-phinjika	
-salala	-salala	
chinyezi	chinyezi	
-uma	-uma	
-konza	-konza	
-fupi	-fupi	
-kutali	-kutali	
-manja	-manja	
-siyidwa	-siyidwa	
pa	pa	
		
ndi	ndi	
ndi	ndi	
nkati	nkati	
chifukwa	chifukwa	t͡ʃiˈfu.kʷá
dzina	dzina	ˈd͡zí.na