mǎ	mǎ	
wǎ	wǎ	
é ñe	é ñe	
bíyǎ	bíyǎ	
mínǎ	mínǎ	
é bɔ be	é bɔ be	
é-ñí	é-ñí	
é-te	é-te	
vá	vá	
váa	váa	
nza?	nza?	
dze?	dze?	
ve?	ve?	
ó dén?	ó dén?	
ya?	ya?	
ka’a	ka’a	
-se	-se	
abuíñ	abuíñ	
-bɔ́’ɔ́	-bɔ́’ɔ́	
avétsáŋ	avétsáŋ	
mbɔ́’ɔ́	mbɔ́’ɔ́	
fɔ́’ɔ́	fɔ́’ɔ́	
bɛ̌	bɛ̌	
láa	láa	
nii	nii	
tân	tân	
-nên	-nên	
ayǎ	ayǎ	
ndam	ndam	
afǐp	afǐp	
adzǐt	adzǐt	
-tɔ́k	-tɔ́k	
etun	etun	
-tɔ́k	-tɔ́k	
-tɔ́k	-tɔ́k	
miniŋá	miniŋá	
fâm	fâm	
mot	mot	
mɔ́ŋ	mɔ́ŋ	
ngáá	ngáá	
nnôm	nnôm	
nané	nané	
tará	tará	
tsít	tsít	
kɔ̌s	kɔ̌s	
onǒn	onǒn	
mvú	mvú	
ñǐn	ñǐn	
ñó	ñó	
nsɔ́ŋ	nsɔ́ŋ	
elé	elé	
afan	afan	
elé	elé	
ebuma	ebuma	
mvɔŋ	mvɔŋ	
okíɛ́ñ	okíɛ́ñ	
ndzi	ndzi	
evîn	evîn	
sǎm	sǎm	
obut	obut	
nkɔɔ́	nkɔɔ́	
eko	eko	
tsít	tsít	
mekǐ	mekǐ	
evěs	evěs	
avɔ̂ŋ	avɔ̂ŋ	
akǐ	akǐ	
nlak	nlak	
ngíém	ngíém	
mvɔ̌t	mvɔ̌t	
nkɔ́	nkɔ́	
nló	nló	
alɔ́	alɔ́	
dzís	dzís	
dzúiñ	dzúiñ	
anu	anu	
asǒŋ	asǒŋ	
dêm	dêm	
dzɛ̂ñ	dzɛ̂ñ	
abɔ	abɔ	
mbíén	mbíén	
abɔ́ŋ	abɔ́ŋ	
wɔ́	wɔ́	
afǎp	afǎp	
abum	abum	
minna	minna	
kíŋ	kíŋ	
mvús	mvús	
nkuk	nkuk	
nlêm	nlêm	
esék	esék	
áñú	áñú	
ádzí	ádzí	
áló	áló	
ávíli	ávíli	
ásɛ metê	ásɛ metê	
áyó	áyó	
ávúŋu	ávúŋu	
ávebe	ávebe	
áwe	áwe	
áyên	áyên	
áwɔ́k	áwɔ́k	
áyem	áyem	
ásíman	ásíman	
ánum	ánum	
ákɔ wɔ̌ŋ	ákɔ wɔ̌ŋ	
áyê	áyê	
átáabe	átáabe	
áwú	áwú	
áwúiñ	áwúiñ	
álúman	álúman	
ásomo	ásomo	
áyít	áyít	
ákík	ákík	
ása	ása	
abé	abé	
ákul	ákul	
áfák	áfák	
ádzɔ́k	ádzɔ́k	
áyéle	áyéle	
áwulu	áwulu	
ánzu	ánzu	
álôm	álôm	
átɔbɔ	átɔbɔ	
ákúiñ	ákúiñ	
ákiŋ	ákiŋ	
áku	áku	
ávé	ávé	
abele	abele	
áyêm	áyêm	
ásíŋile	ásíŋile	
áso	áso	
áfími	áfími	
áduru	áduru	
átsíni	átsíni	
áwua	áwua	
ákák	ákák	
átsûm	átsûm	
álâŋ	álâŋ	
ádzó	ádzó	
áyee	áyee	
ádɔ abia	ádɔ abia	
áyêŋ	áyêŋ	
ási’i	ási’i	
ávúébe	ávúébe	
ávús	ávús	
nló	nló	
ngɔn	ngɔn	
otéteñ	otéteñ	
mendzím	mendzím	
mveŋ	mveŋ	
osúiñ	osúiñ	
elíbá	elíbá	
mâŋ	mâŋ	
nkǔ	nkǔ	
akɔ́k	akɔ́k	
nséga	nséga	
mbúlúk	mbúlúk	
sí	sí	
nkút	nkút	
nkút	nkút	
yó	yó	
mfoŋa	mfoŋa	
0	0	
efén mendzím	efén mendzím	
otsíra	otsíra	
ndúan	ndúan	
asǔp	asǔp	
ádzík	ádzík	
nsénéŋé	nsénéŋé	
nkóó	nkóó	
evéle	evéle	
mendza’á	mendza’á	
atsúíñ	atsúíñ	
afúm	afúm	
nsút	nsút	
alú	alú	
mǒs	mǒs	
mbú	mbú	
ayôŋ	ayôŋ	
avóeñ	avóeñ	
abôm	abôm	
mfefeñ	mfefeñ	
nnǒm	nnǒm	
mvɛ̂ñ	mvɛ̂ñ	
mbé	mbé	
ebɔɔ́	ebɔɔ́	
mvin	mvin	
tételé	tételé	
mvígélé	mvígélé	
akáp	akáp	
atǔ	atǔ	
ekokɔn	ekokɔn	
mbara	mbara	
nkór	nkór	
tételé	tételé	
bebɛñ	bebɛñ	
oyǎp	oyǎp	
meyôm	meyôm	
meyáá	meyáá	
á	á	
été	été	
ya	ya	
ya	ya	
ngé	ngé	
amú náá	amú náá	
dzúiñ	dzúiñ	