nna	nna	
wena	wena	
yona	yona	
rona	rona	
lona	lona	
bona	bona	
ana	ana	
aa	aa	
mona	mona	
ao	ao	
mang	mang	
eng	eng	
kae	kae	
neng	neng	
jwang	jwang	
ha	ha	
bohle	bohle	
ngata	ngata	
bang	bang	
mmalwa	mmalwa	
engwe	engwe	
nngwe	nngwe	
pedi	pedi	
tharo	tharo	
nne	nne	
hlano	hlano	
-holo	-holo	
-lelele	-lelele	
-batsi	-batsi	
-tenya	-tenya	
-boima	-boima	
-nyane	-nyane	
-kgutshwane	-kgutshwane	
-tshesane	-tshesane	
-sesane	-sesane	
mosadi	mosadi	
monna	monna	
motho	motho	
ngwana	ngwana	
mohatsa	mohatsa	
mohatsa	mohatsa	
mme	mme	
ntate	ntate	
phoofolo	phoofolo	
hlapi	hlapi	
nonyana	nonyana	
ntja	ntja	
		
noha	noha	
seboko	seboko	
sefate	sefate	
moru	moru	
thupa	thupa	
tholwana	tholwana	
peo	peo	pew
lehlaku	lehlaku	
motso	motso	
lekgapetla	lekgapetla	
palesa	palesa	
jwang	jwang	
mohala	mohala	
letlalo	letlalo	
nama	nama	
madi	madi	
lesapo	lesapo	
mafura	mafura	
lehe	lehe	
lenaka	lenaka	
mohatla	mohatla	
lesiba	lesiba	
moriri	moriri	
hlooho	hlooho	
tsebe	tsebe	
leihlo	leihlo	
nko	nko	
molomo	molomo	
leino	leino	
leleme	leleme	
lenala	lenala	
leoto	leoto	
moomo	moomo	
lengole	lengole	
letsoho	letsoho	
lepheo	lepheo	
mpa	mpa	
dikahare	dikahare	
molala	molala	
mokokotlo	mokokotlo	
letswele	letswele	
pelo	pelo	
sebete	sebete	
nwa	nwa	
ja	ja	
loma	loma	
monya	monya	
tshwela	tshwela	
hlatsa	hlatsa	
fefola	fefola	
phefumoloha	phefumoloha	
tsheha	tsheha	
bona	bona	
utlwa	utlwa	
tseba	tseba	
nahana	nahana	
fofonela	fofonela	
tshaba	tshaba	
robala	robala	
phela	phela	
shwa	shwa	
bolaya	bolaya	
lwana	lwana	
tsoma	tsoma	
bata	bata	
phoma	phoma	
arohana	arohana	
hlaba	hlaba	
ngwapa	ngwapa	
epa	epa	
sesa	sesa	
fofa	fofa	
tsamaya	tsamaya	
tla	tla	
botha	botha	
dula	dula	
ema	ema	
reteleha	reteleha	
wa	wa	
fa	fa	
tshwara	tshwara	
tlhotla	tlhotla	
pikitla	pikitla	
hlatswa	hlatswa	
hlakola	hlakola	
hula	hula	
susumetsa	susumetsa	
akga	akga	
fasa	fasa	
roka	roka	
bala	bala	
bolela	bolela	
bina	bina	
bapala	bapala	
phaphamala	phaphamala	
phalla	phalla	
		
ruruha	ruruha	
letsatsi	letsatsi	
kgwedi	kgwedi	
naledi	naledi	
metsi	metsi	
pula	pula	
noka	noka	
letsha	letsha	
lewatle	lewatle	
letswai	letswai	
lejwe	lejwe	
lehlabathe	lehlabathe	
lerole	lerole	
mobu	mobu	
leru	leru	
mohodi	mohodi	
lehodimo	lehodimo	
moya	moya	
lehlwa	lehlwa	
leqhwa	leqhwa	
mosi	mosi	
mollo	mollo	
molora	molora	
besa	besa	
tsela	tsela	
thaba	thaba	
-fubedu	-fubedu	
-tala	-tala	
-sehla	-sehla	
-sweu	-sweu	
-tsho	-tsho	
bosiu	bosiu	
mohla	mohla	
selemo	selemo	
-futhumetse	-futhumetse	
-serame	-serame	
-tletse	-tletse	
-tjha	-tjha	
-holo	-holo	
-tle	-tle	
-be	-be	
bodileng	bodileng	
ditshila	ditshila	
otlolohileng	otlolohileng	
-tjhitja	-tjhitja	
bohale	bohale	
nthithi	nthithi	
boreledi	boreledi	
metsi	metsi	
-omisa	-omisa	
nepisa	nepisa	
haufi	haufi	
hole	hole	
lokisa	lokisa	
leqele	leqele	
		
ka	ka	
na	na	
le	le	
ha	ha	
hobane	hobane	
lebitso	lebitso	