yo	yo	
tu	tu	
ell	ell	
nusatros	nusatros	nuˈsatɾos
vusatros	vusatros	
ellos	ellos	
iste	iste	
ixe	ixe	
aquí	aquí	
allí	allí	
quí	quí	
qué	qué	
a	a	
quan	quan	
cómo	cómo	
no	no	
tot	tot	ˈtot
muitos	muitos	
bells	bells	
poco	poco	
atro	atro	
un	un	
dos	dos	
tres	tres	
quatre	quatre	
cinco	cinco	
gran	gran	ˈɡɾan
largo	largo	
amplo	amplo	
recio	recio	
pesau	pesau	
chiquet	chiquet	t͡ʃiˈket
curto	curto	
estreito	estreito	
fino	fino	
muller	muller	
hombre	hombre	
hombre	hombre	
nino	nino	
muller	muller	
mariu	mariu	
mai	mai	
pai	pai	
animal	animal	
peix	peix	
au	au	ˈau̯
can	can	
piollo	piollo	
serpient	serpient	
cuco	cuco	
arbol	arbol	
selva	selva	
tocho	tocho	
fruito	fruito	
simient	simient	
fuella	fuella	
radiz	radiz	
crosta	crosta	
flor	flor	
hierba	hierba	
cuerda	cuerda	
piel	piel	
carne	carne	ˈkaɾne
sangre	sangre	
ueso	ueso	
graixa	graixa	
uego	uego	ˈweɡo
cuerno	cuerno	
coda	coda	
pluma	pluma	
pelo	pelo	
cabeza	cabeza	
orella	orella	oˈɾeʎa
uello	uello	ˈweʎo
nariz	nariz	
boca	boca	
dient	dient	
luenga	luenga	
unya	unya	
piet	piet	
garra	garra	ˈɡara
chenullo	chenullo	t͡ʃeˈnuʎo
man	man	
ala	ala	
pancha	pancha	
budiellos	budiellos	
fogueta	fogueta	
espalda	espalda	
peito	peito	
corazón	corazón	koɾaˈθon
figado	figado	
beber	beber	
minchar	minchar	minˈt͡ʃa(ɾ)
mosegar	mosegar	
chorrupar	chorrupar	
escupir	escupir	
vomecar	vomecar	bomeˈka(ɾ)
bufar	bufar	
respirar	respirar	
redir	redir	reˈdi(ɾ)
veyer	veyer	
sentir	sentir	
saber	saber	
pensar	pensar	
ulorar	ulorar	
temer	temer	
adormir	adormir	
vivir	vivir	
morir	morir	
matar	matar	
luitar	luitar	lwiˈta(ɾ)
cazar	cazar	
trucar	trucar	
tallar	tallar	
partir	partir	
apunyalar	apunyalar	
arrascar	arrascar	
cavar	cavar	
nadar	nadar	naˈda(ɾ)
volar	volar	
caminar	caminar	
venir	venir	
chacer	chacer	t͡ʃaˈθe(ɾ)
posar	posar	
estar	estar	esˈta(ɾ)
chirar	chirar	
cayer	cayer	
dar	dar	
sustener	sustener	
pretar	pretar	
esfregar	esfregar	
lavar	lavar	
aixugar	aixugar	
estirar	estirar	
empentar	empentar	
chitar	chitar	t͡ʃiˈta(ɾ)
ligar	ligar	
cusir	cusir	
contar	contar	
decir	decir	
cantar	cantar	
chugar	chugar	t͡ʃuˈɡa(ɾ)
flotar	flotar	
fluyir	fluyir	
chelar	chelar	
inflar	inflar	
sol	sol	
luna	luna	
estrela	estrela	
augua	augua	ˈau̯ɡwa
plevia	plevia	
riu	riu	
laco	laco	
mar	mar	
sal	sal	
piedra	piedra	
arena	arena	aˈɾena
polvo	polvo	
tierra	tierra	
boira	boira	
boira	boira	
ciel	ciel	
aire	aire	
nieu	nieu	ˈnjeu̯
chelo	chelo	
fumo	fumo	
fuego	fuego	
cenisa	cenisa	
cremar	cremar	
camín	camín	
mont	mont	
royo	royo	ˈroʝo
verde	verde	ˈbeɾde
amariello	amariello	
blanco	blanco	ˈblanko
negro	negro	ˈneɡɾo
nueit	nueit	
día	día	
anyo	anyo	ˈaɲo
calient	calient	
fredo	fredo	
pleno	pleno	
nuevo	nuevo	
viello	viello	ˈbjeʎo
bueno	bueno	
malo	malo	
pudriu	pudriu	
puerco	puerco	
recto	recto	
redondo	redondo	reˈdondo
esmolau	esmolau	
ciego	ciego	
suau	suau	
humedo	humedo	
ixuto	ixuto	
correcto	correcto	
amán	amán	
luent	luent	
dreita	dreita	
cucha	cucha	
a	a	
a	a	
con	con	
y	y	
si	si	
perque	perque	
nombre	nombre	ˈnombɾe