ieu	ieu	ˈjew
tu	tu	ty
el	el	
nosautres	nosautres	
vosautres	vosautres	
eles	eles	
aqueste	aqueste	aˈkeste
aquel	aquel	a.kɛl
aicí	aicí	
ailà	ailà	
quin	quin	kin
qué	qué	ke
ont	ont	ˈunt
quand	quand	
consí	consí	
pas	pas	
tot	tot	tut
fòrça	fòrça	
qualque	qualque	
pauc	pauc	
autre	autre	
un	un	ˈy
dos	dos	ˈdus
tres	tres	ˈtɾes
quatre	quatre	ˈka.tɾe
cinc	cinc	ˈsiŋk
bèl	bèl	
long	long	
larg	larg	
espés	espés	
pesuc	pesuc	
pichòt	pichòt	
cort	cort	
estrech	estrech	
fin	fin	
femna	femna	ˈfennɒ
òme	òme	ˈɔme
òme	òme	ˈɔme
enfant	enfant	
esposa	esposa	
espós	espós	
maire	maire	ˈmajɾe
paire	paire	ˈpajɾe
animal	animal	
peis	peis	
aucèl	aucèl	awˈsɛl
gos	gos	ˈɡus
pesolh	pesolh	peˈzuʎ
sèrp	sèrp	
vèrm	vèrm	
aubre	aubre	
bòsc	bòsc	bɔsk
baston	baston	
fruch	fruch	
semen	semen	
fuèlha	fuèlha	ˈfɥɛ.ʎo
rasiga	rasiga	
rusca	rusca	
flor	flor	ˈflu
èrba	èrba	ˈɛrβo
còrda	còrda	
pèl	pèl	ˈpɛl
carn	carn	
sang	sang	
òs	òs	ˈɔs
grais	grais	
uòu	uòu	
bana	bana	
coá	coá	
pluma	pluma	
pel	pel	ˈpel
cap	cap	kap
aurelha	aurelha	awˈɾeʎo
uèlh	uèlh	ˈɥɛl
nas	nas	
boca	boca	buko
dent	dent	
lenga	lenga	ˈleŋ.ɡo̞
ongla	ongla	ˈuŋɡlo
pè	pè	pɛ
camba	camba	ˈkambo
genolh	genolh	(d)ʒeˈnul
man	man	ma
ala	ala	alo̞
ventre	ventre	
tripa	tripa	
còl	còl	
esquina	esquina	
pièch	pièch	
còr	còr	ˈkɔɾ
fetge	fetge	
beure	beure	ˈbewre
manjar	manjar	manˈd͡ʒa
mossegar	mossegar	
chucar	chucar	
escopir	escopir	
racar	racar	
bofar	bofar	
alenar	alenar	
rire	rire	
veire	veire	ˈbej.ɾe
ausir	ausir	
saber	saber	
pensar	pensar	
sentir	sentir	
crénher	crénher	
dormir	dormir	
viure	viure	
morir	morir	muˈɾi
tuar	tuar	tyˈa
se	se	
caçar	caçar	kaˈsa
trucar	trucar	
talhar	talhar	
partir	partir	
estocar	estocar	
rascar	rascar	
cavar	cavar	
nadar	nadar	naˈdaɾ
volar	volar	
anar	anar	
venir	venir	
jaire	jaire	
se	se	
estar	estar	
virar	virar	biˈɾa
caire	caire	ˈkaj.ɾe
bailar	bailar	
tenir	tenir	
pressar	pressar	
fretar	fretar	
lavar	lavar	
eissugar	eissugar	ejsyˈɣa
tirar	tirar	
butar	butar	
lançar	lançar	
estacar	estacar	
coire	coire	ˈkujɾe
comptar	comptar	
dire	dire	ˈdi.ɾe
cantar	cantar	kanˈta
jogar	jogar	d͡ʒuˈɡa
flotar	flotar	
rajar	rajar	
gelar	gelar	
coflar	coflar	
solelh	solelh	suˈlɛl
luna	luna	ˈlyno
estela	estela	esˈte.lɔ
aiga	aiga	ˈajɡɒ
pluèja	pluèja	ˈplɥɛ(d)ʒo
riu	riu	ˈrriw
lac	lac	
mar	mar	
sal	sal	
pèira	pèira	ˈpɛj.ɾo
sabla	sabla	ˈsaβlo
polvèra	polvèra	
tèrra	tèrra	
nívol	nívol	
bruma	bruma	
cèl	cèl	ˈʃjaʷ
vent	vent	
nèu	nèu	ˈnɛw
glaç	glaç	
fum	fum	
fuòc	fuòc	ˈfɥɔk
cendre	cendre	
cremar	cremar	
camin	camin	
montanha	montanha	munˈtaɲo
roge	roge	ˈʁu.d͡ʒe
verd	verd	ˈbert
jaune	jaune	
blanc	blanc	
negre	negre	
nuèch	nuèch	ˈnɥɛtʃ
jorn	jorn	
an	an	
caud	caud	ˈkau̯
freg	freg	
plen	plen	
nòu	nòu	ˈnɔw
vièlh	vièlh	bjɛl
bon	bon	
marrit	marrit	
poirit	poirit	
lord	lord	
drech/drèit	drech/drèit	
redond	redond	
agusat	agusat	
		
doç	doç	
trempe	trempe	
sec	sec	
corrècte	corrècte	
prèp	prèp	
luènh	luènh	
drecha/drèita	drecha/drèita	
esquèrra	esquèrra	
a	a	a
dins	dins	
amb	amb	amb
e	e	
se	se	
perque	perque	
nom	nom	