io	io	
tu	tu	
ie	ie	
noi	noi	
voi	voi	
ieľ	ieľ	
ţăsta	ţăsta	
ţel	ţel	
		
colo	colo	
		
ţe	ţe	
		
cănd	cănd	
		
		
tot	tot	
		
		
		
åt	åt	
ur	ur	
doi	doi	
trei	trei	
påtru	påtru	
cinc	cinc	
		
		
		
		
		
		
		
		
		
		
bărbåt	bărbåt	bərˈbwɔt
		
		
		
		
		
		
ciåce	ciåce	
		
		
		
		
şerp	şerp	
		
årbure	årbure	
		
		
		
		
		
		
		
		
		
		
		
		
sănze	sănze	
		
		
		
		
		
		
per	per	
cåp	cåp	
		
		
nås	nås	
		
		
limbe	limbe	
		
pićor	pićor	
pićor	pićor	
		
		
		
		
		
		
		
		
		
		
be	be	
mâncå	mâncå	
		
		
		
		
		
		
		
		
åvzi	åvzi	
		
misli	misli	
		
		
durmi	durmi	
		
		
		
båte	båte	
		
		
		
		
		
		
		
		
		
		
		
		
		
		
		
căde	căde	
		
		
		
		
		
		
		
		
		
		
		
		
spure	spure	
cântå	cântå	
		
		
		
		
		
		
		
ste	ste	
åpe	åpe	wɔpe
		
		
		
		
		
		
		
		
pemint	pemint	
		
		
țer	țer	t͡ser
		
		
		
		
foc	foc	
		
årdu	årdu	
cåle	cåle	
		
		
zelen	zelen	
		
åb	åb	wɔb
negru	negru	
		
zi	zi	
ån	ån	ɔn
		
		
plir	plir	
		
		
bur	bur	
		
		
		
		
		
		
		
		
		
		
		
aprope	aprope	
		
		
		
		
		
		
		
		
che	che	
nome	nome	