আমি	ami	ami
তুমি	tumi	t̪umi
সে	śe	ʃe
আমরা	amra	amɾa
তোমরা	tōmra	
তারা	tara	t̪aɾa
এ	e	e
ও	ō	o
এখানে	ekhane	ˈe.kʰa.ne
ওখানে	ōkhane	okʰane
কে	ke	
কী	ki	
কোথায়	kōthaẏ	kot̪ʰae̯
কখন	kokhon	kɔkʰɔn
কেমন	kemon	
না	na	na
সব	śbo	ʃɔb
অনেক	onek	ɔnek
কিছু	kichu	kitʃʰu
কম	kom	kɔm
অন্য	onno	onːo
এক	ek	æk
দুই	dui	d̪u̯i
তিন	tin	t̪in
চার	car	tʃaɾ
পাঁচ	pãc	pãtʃ
বড়	boṛ	bɔɽo
লম্বা	lomba	
চওড়া	coōṛa	tʃɔo̯ɽa
মোটা	mōṭa	ˈmoʈa
ভারী	bhari	
ছোট	chōṭ	tʃʰoʈo
বেঁটে	bẽṭe	
চিপা	cipa	
পাতলা	patola	pat̪la
মহিলা	mohila	moɦila
পুরুষ	puruś	pu.ruʃ
মানুষ	manuś	manuʃ
বাচ্চা	bacca	batʃːa
স্ত্রী	stri	stri
স্বামী	śami	ʃami
মা	ma	ma
বাবা	baba	baba
জন্তু	jontu	dʒɔnt̪u
মাছ	mach	mɑt͡ʃʰ
পাখি	pakhi	pakʰi
কুকুর	kukur	ku.kuɹ
উকুন	ukun	
সাপ	śap	ʃap
কৃমি	krimi	
গাছ	gach	ɡatʃʰ
বন	bon	bon
লাঠি	laṭhi	ˈla.tʰi
ফল	phol	pʰɔl
বীচি	bici	ˈbitʃi
পাতা	pata	pata
শিকড়	śikoṛ	
ছাল	chal	
ফুল	phul	pʰul
ঘাস	ghaś	
দড়ি	doṛi	do.ɽi
চামড়া	camṛa	tʃamɽa
মাংস	maṅśo	maŋ.ʃɔ
রক্ত	rokto	ˈrɔk.t̪o
হাড়	haṛ	ɦaɽ
চর্বি	corbi	tʃoɾbi
ডিম	ḍim	ɖim
শিং	śiṅ	ʃiŋ
লেজ	lej	
পর	por	pɔɾ
চুল	cul	tʃul
মাথা	matha	ma.tʰa
কান	kan	kan
চোখ	cōkh	tʃokʰ
নাক	nak	nak
মুখ	mukh	mukʰ
দাঁত	dãt	d̪ãt̪
জিভ	jibh	dʒibʱ
নখ	nokh	nɔkʰ
পা	pa	pa
পা	pa	pa
হাঁটু	hãṭu	ɦãʈu
হাত	hat	ɦat̪
পাখা	pakha	pakʰa
পেট	peṭ	
ভুড়ী	bhuṛi	
গলা	gola	ɡɔla
পিঠ	piṭh	piʈʰ
বুক	buk	
হৃদয়	hridoẏ	ɦɾid̪ɔe̯
কলিজা	kolija	kolidʒa
পান	pan	pan
খাওয়া	khaōẇa	kʰao̯a
কামড়ানো	kamṛanō	ˈkam.ɽ̟aˌno
চোষা	cōśa	tʃoʃa
ছ্যাপ	chêp	
বমি	bomi	bomi
ফুঁ	phũ deōẇa	
শ্বাস	śśaś neōẇa	s̠äːs̠
হাসা	haśa	ɦaʃa
দেখা	dekha	ˈd̪ækʰa
শোনা	śōna	ʃona
জানা	jana	dʒana
ভাবা	bhaba	bʰa.ba
শোঁকা	śō̃ka	
ভয়	bhoẏ kora	bʱɔe̯
ঘুমানো	ghumanō	ˈɡʱu.maˌno
বাঁচা	bãca	bãtʃa
মরা	mora	mɔɾa
মারা	mara	
লড়া	loṛa	lɔɽa
স্বীকার	śikar kora	ʃi.kar
মারা	mara	
কাটা	kaṭa	ˈkɑ.ʈɑ
বিভক্ত	bibhokto kora	
ছোরা	chōra mara	
খামচানো	khamcanō	
খোঁড়ানো	khō̃ṛanō	kʰo.ɽa.no
সাঁতরানো	śãtranō	ʃãt̪.ra.no
ওড়া	ōṛa	oɽa
হাঁটা	hãṭa	hã.ʈa
আসা	aśa	aʃa
শোয়া	śōẇa	ʃo̯a
বসা	bośa	ˈbɔʃa
দাঁড়ানো	dãṛanō	d̪ãɽano
ঘোরা	ghōra	ˈɡʱo.ra
পড়া	poṛa	pɔɽa
দেওয়া	deōẇa	d̪æo̯a
ধরা	dhora	dʱɔ.ra
চেপ-	cep-	
ঘষা	ghośa	ɡʱɔʃa
ধোয়া	dhōẇa	d̪ʱo̯a
মোছা	mōcha	
টানা	ṭana	ʈa.na
ঠেলা	ṭhela	ˈʈ̟ʰæ.la
ফেলা	phela	fæla
বাঁধা	bãdha	ˈbã.d̪ʱa
টাঁকা	ṭãka	
গোনা	gōna	ɡo.na
বলা	bola	bɔla
গাওয়া	gaōẇa	ɡao̯a
খেলা	khela	kʰæla
ভাসা	bhaśa	bʱaʃa
বহা	boha	
জমা	joma	
ফাঁপা	phãpa	
সূর্য	śurjo	ʃuɾdʒo
চাঁদ	cãd	tʃãd̪
তারা	tara	t̪aɾa
পানি	pani	pani
বৃষ্টি	briśṭi	bɾiʃʈi
নদী	nodi	nod̪i
হ্রদ	hrod	ɦɾɔd̪
সমুদ্র	śomudro	ʃo.mud.ro
নুন	nun	nun
পাথর	pathor	pa.tʰor
বালি	bali	ba.li
ধুলা	dhula	
মাটি	maṭi	ma.ʈi
মেঘ	megh	meɡʱ
কুয়াশা	kuẏaśa	ku̯aʃa
আকাশ	akaś	a.kaʃ
বাতাস	bataś	ba.taʃ
বরফ	boroph	bɔɾopʰ
বরফ	boroph	bɔɾopʰ
ধোঁয়া	dhō̃ẇa	d̪ʱõa
আগুন	agun	aɡun
ছাই	chai	tʃʰai̯
পোড়া	pōṛa	po.ɽa
রাস্তা	rasta	ɹas.t̪a
পাহাড়	pahaṛ	pa.haɽ
লাল	lal	lal
সবুজ	śobuj	ʃobudʒ
হলুদ	holud	
সাদা	śada	ʃad̪a
কালো	kalō	kalo
রাত্রি	ratri	
দিন	din	d̪in
বছর	bochor	bɔtʃʰoɾ
গরম	gorom	ɡɔɾom
ঠান্ডা	ṭhanḍa	ʈʰanɖa
ভরা	bhora	bʰɔ.ra
নতুন	notun	not̪un
পুরানো	puranō	puɾano
ভালো	bhalō	bʱalo
খারাপ	kharap	kʰaɾap
পচা	poca	pɔtʃa
ময়লা	moẏla	mɔʲla
সোজা	śōja	ʃodʒa
গোল	gōl	
চোক্ষা	cōkkha	
ভোঁতা	bhō̃ta	
মসৃণ	mosrin	
ভেজা	bheja	
শুকনা	śukona	
ঠিক	ṭhik	
কাছে	kache	katʃʰe
দূর	dur	
ডান	ḍan	ɖan
বাঁ	bã	bã
-এ	-e	
-এ	-e	
-র	-ro śathe	
আর	ar	aɾ
যদি	jodi	dʒod̪i
কারণ	karon	ka.ron
নাম	nam	nam