مَیں‎	ma͠i	
تُوں‎	tū̃	
او‎	o	oː
اَسّاں‎	assā̃	
تُسّاں‎	tussā̃	
او‎	o	oː
اے‎	e	
او‎	o	oː
اِتّھے‎	itthe	
اُتّھے‎	utthe	
کَوݨ‎	kauṇ	
کی	kī śe	
کِتّھاں‎	kitthā̃	
کݙّاں‎	kaɗɗā̃	
کِیویں‎	kĩvẽ	
نہ‎	na	
سارے‎	sāre	
ٻہُوں‎	ɓahũ	
کُجھ‎	kujh	
تھوڑا‎	thoṛā	
ݙُوجھا‎	ɗujjhā	
ہِک‎	hik	
ݙُو‎	ɗū	
ترائے‎	trāe	t̪ə.ɾɛː
چار‎	cār	t͡ʃaːɾ
پنج‎	pãj	pə̃d͡ʒ
وݙّا‎	vaɗɗā	vəɗ.ɗaː
لمبا‎	lambā	
		
موٹا‎	moṭā	
بارا‎	bārā	
چھوٹا‎	choṭā	
چھوٹا‎	choṭā	
سَوڑا‎	soṛā	
پَتلا‎	patlā	
رن‎	ran	
ڄݨا‎	ʄaṇā	
بَندہ‎	banda	
ٻال‎	ɓāl	ɓaːl
زال‎	zāl	
پَے‎	pae	
ما‎	mā	
پِیؤُ‎	pīu	
جانوَر‎	jānvar	
مَچّھی‎	macchī	
پَکّھی‎	pakkhī	
کُتّا‎	kuttā	
جُوں‎	jū̃	
نانگ‎	nāṅg	nãːɡ
کِیڑا‎	kīṛā	
درَخت‎	draxt	
جنگل‎	jaṅgal	
ݙنْڈا‎	ɗaṇḍā	
		
بِیج‎	bīj	
پَتْر‎	patr	
پاڑ‎	pāṛ	
چِھل‎	chill	
پُھل‎	phul	
گھاہ‎	ghāh	
رسّا‎	rassā	
کَھل‎	khal	
گوشت‎	gośt	ɡoːʃt̪
رَتّ‎	ratt	
ہݙّی‎	haɗɗī	
مین٘جھ‎	mī̃jh	
انڈہ‎	anḍā	
سِنْگھ‎	siṅgh	
پچھ‎	puch	
کھمبھ‎	khambh	
وال‎	vāl	vaːl
سِر‎	sir	
کَنّ‎	kann	
اَکّھ‎	akkh	
نَکّ‎	nakk	
مُنْہ‎	mũh	
ݙنْد‎	ɗand	
ڄِبّھ‎	ʄibbh	
نَؤُں‎	naū̃	
پیر‎	per	peːɾ
ڄنْگھ‎	ʄaṅgh	
ڳوݙا‎	ɠoɗā	ɠoː.ɗaː
ہَتّھ‎	hatth	
پَر‎	par	
ڈِھڈھ‎	ḍhiḍh	
آنْدْر‎	āndr	
ڳِچّی‎	ɠiccī	
کَنْڈھ‎	kanḍh	
سِینہ‎	sīnā	
دِل‎	dil	
جِگَر‎	jigar	
پِیوݨ‎	pīvaṇ	
کھاوَݨ‎	khāvaṇ	
پَٹّݨ‎	paṭṭaṇ	
چُوپݨ‎	cūpaṇ	
تُھک	thukk saṭṭaṇ	
اُلٹی	ulṭī karaṇ	
پُھوکَݨ‎	phūkaṇ	
ساہ	sāh ghinnaṇ	
کِھلّݨ‎	khillaṇ	
ݙیکھݨ‎	ɗekhaṇ	ɗeː.kʰəɳ
سُݨݨ‎	suṇaṇ	
ڄاݨݨ‎	ʄāṇaṇ	
سوچݨ‎	socaṇ	
سِنْگھݨ‎	siṅghaṇ	
ݙرݨ‎	ɗaraṇ	
سُمھݨ‎	sumhaṇ	
جِیوَݨ‎	jīvaṇ	
مَرَݨ‎	maraṇ	
مارَݨ‎	māraṇ	
بِھڑَݨ‎	bhiṛaṇ	
شِکار	śikār karaṇ	
ٹکراوَݨ‎	ṭakrāvaṇ	
کپݨ‎	kappaṇ	
چیرݨ‎	cīraṇ	
		
کھنھݨ‎	khanhaṇ	
کھٹݨ‎	khaṭṭaṇ	
تَرَݨ‎	taraṇ	
اُݙَّݨ‎	uɗaṇ	
ٹُرَݨ‎	ṭuraṇ	
آوَݨ‎	āvaṇ	
لیٹݨ‎	leṭaṇ	
ٻَہوَݨ‎	ɓahvaṇ	
کھڑݨ‎	khaṛaṇ	
مُڑَݨ‎	muṛaṇ	
ڈھاوݨ‎	ḍhāvaṇ	
ݙیوَݨ‎	ɗevaṇ	
نپّݨ‎	nappaṇ	
گُھٹَّݨ‎	ghuṭṭaṇ	
رَڳْڑَݨ‎	raɠṛaṇ	
دھووَݨ‎	dhovaṇ	
پُونجھݨ‎	pū̃jhaṇ	
چِھکَّݨ‎	chikkaṇ	
دِھکّا	dhakkā dīvaṇ	
سَٹَّݨ‎	saṭṭaṇ	
ٻنھݨ‎	ɓanhaṇ	
سِیوَݨ‎	sīvaṇ	
ڳِݨݨ‎	ɠiṇaṇ	
آکھݨ‎	ākhaṇ	aː.kʰəɳ
ڳاوَݨ‎	ɠāvaṇ	
کھیݙَݨ‎	kheɗaṇ	
تَرَݨ‎	taraṇ	
واہَݨ‎	vāhaṇ	
ڄَم	ʄam vanʄaṇ	
سُڄَّݨ‎	suʄʄaṇ	
ݙین٘ہہ‎	ɗẽh	ɗẽːh
چن‎	can	t͡ʃən
تارا‎	tārā	
پاݨی‎	pāṇī	paː.ɳiː
مِینْہہ‎	mī̃h	
دریا‎	daryā	
جِھیل‎	jhīl	
سَمَنْدَر‎	samandar	
لُوݨ‎	lūṇ	
پتّھر‎	patthar	
ریت‎	ret	
دُھوڑ‎	dhūṛ	
بھوئیں‎	bhūī̃	
بَدَّل‎	baddal	
دُھند‎	dhund	
اَسمان‎	āsmān	
ہَوا‎	havā	
بَرَف‎	baraf	
بَرَف‎	baraf	
دُھواں‎	dhū̃ā̃	
بھاہ‎	bhāh	bʰaː(h)
سُؤا‎	suā	
ٻَلَّݨ‎	ɓallaṇ	
سَڑْک‎	saṛk	
روہ‎	ravā	
رَتّا‎	rattā	
ساوا‎	sāvā	
پِیلا‎	pīlā	
چِٹّا‎	ciṭṭā	
کالا‎	kālā	
رات‎	rāt	
ݙِینْہہ‎	ɗī̃hā	
سال‎	sāl	
تَتّا‎	tattā	
ٹَھڈھا‎	ṭhaḍhā	
پُورا‎	pūrā	
نَواں‎	navā̃	
ٻُڈّھا‎	ɓuḍḍhā	
چنْڳاں‎	caṅɠā̃	
گنْدا‎	gandā	
ڳلیا	ɠalel hoyā	
گنْدا‎	gandā	
سِدّھا‎	siddhā	
گول‎	gol	
تِکّھا‎	tikkhā	
کَودَن‎	kaudan	
برابر‎	barābar	
سِنّاں‎	sinnā̃	
سُکّا‎	sukkā	
درُست‎	darust	
نیڑے‎	neṛe	
پَریں‎	parẽ	
سڄّا‎	saʄʄā	
کھٻّا‎	khaɓɓā	
اُتے‎	ute	
اِچ‎	ic	
نال‎	nāl	
اتے‎	ate	
جے‎	je	
کِیُونْجو‎	kīū̃jo	
ناں‎	nā̃	