میں‎	ma͠i	mɛ̃ː
تو‎	tū	t̪uː
یہ‎	yeh	jeː
ہم‎	ham	ɦəm
تم‎	tum	t̪ʊm
یہ‎	yeh	jeː
یہ‎	yeh	jeː
وہ‎	voh	ʋoː
یہاں‎	yahā̃	jə.ɦɑ̃ː
وہاں‎	vahā̃	ʋə.ɦɑ̃ː
کون‎	kaun	kɔːn
کیا‎	kyā	kjɑː
کہاں‎	kahā̃	kə.ɦɑ̃ː
کب‎	kab	kəb
کیسا‎	kaisā	
نہیں‎	nahī̃	nə.ɦĩː
سب‎	sab	səb
بہت‎	bahut	bə.ɦoːt̪
کچھ‎	kuch	kʊt͡ʃʰ
تھوڑا‎	thoṛā	
دوسرا‎	dūsrā	d̪uːs.ɾɑː
یک‎	ek	jək
دو‎	do	d̪oː
تین‎	tīn	t̪iːn
چار‎	cār	t͡ʃɑːɾ
پاںچ‎	pānc	
بڑا‎	baṛā	bə.ɽɑː
لمبا‎	lambā	ləm.bɑː
چوڑا‎	cauṛā	t͡ʃɔː.ɽɑː
گاڑھا‎	gāṛhā	
بھاری‎	bhārī	
چھوٹا‎	choṭā	t͡ʃʰoː.ʈɑː
چھوٹا‎	choṭā	t͡ʃʰoː.ʈɑː
تنگ‎	tang	t̪əŋɡ
پتلا‎	patlā	
عورت‎	'aurat	ɔː.ɾət̪
آدمی‎	ādmī	ɑːd̪.miː
انسان‎	insān	ɪn.sɑːn
بچه‎	baccā	
بیوی‎	bīvī	biː.ʋiː
شوہر‎	śauhar	ʃɔː.ɦəɾ
ماں‎	mā̃	
ابّو‎	abbū	
جانور‎	jānvar	d͡ʒɑːn.ʋəɾ
مچھلی‎	machlī	mət͡ʃʰ.liː
چڑیا‎	ciṛiyā	t͡ʃɪ.ɽɪ.jɑː
کتا‎	kuttā	kʊt̪.t̪ɑː
جوں‎	jū̃	d͡ʒũː
سانپ‎	sānp	sɑ̃ːp
کیڑا‎	kīṛā	kiː.ɽɑː
درخت‎	daraxt	d̪ə.ɾəxt̪
جنگل‎	jangal	d͡ʒəŋ.ɡəl
ڈنڈا‎	ḍanḍā	
پھل‎	phal	pʰəl
بیج‎	bīj	
پتا‎	pattā	pə.t̪ɑː
جڑ‎	jaṛ	d͡ʒəɽ
چھال‎	chāl	t͡ʃʰɑːl
پھول‎	phūl	pʰuːl
گھاس‎	ghās	ɡʱɑːs
رسی‎	rassī	ɾəsː.iː
جلد‎	jild	
گوشت‎	gośt	ɡoːʃt̪
خون‎	xūn	xuːn
ہڈی‎	haḍḍī	ɦəɖː.iː
چربی‎	carbī	t͡ʃəɾ.biː
انڈہ‎	anḍā	
سینگ‎	sīng	siːŋɡ
پونچهـ‎	pūnch	
پر‎	par	pəɾ
بال‎	bāl	bɑːl
سر‎	sar	
کان‎	kān	kɑːn
آںکھ‎	ā̃kh	
ناک‎	nāk	nɑːk
منہ‎	munh	mũːɦ
دانت‎	dānt	d̪ɑ̃ːt̪
زبان‎	zabān	zə.bɑːn
ناخن‎	nāxun	nɑː.xʊn
پیر‎	pair	pɛːɾ
ٹانگ‎	ṭāng	ʈɑːŋɡ
گھٹنا‎	ghuṭnā	ɡʱʊʈ.nɑː
ہاتھ‎	hāth	ɦɑːt̪ʰ
بازو‎	bāzū	bɑː.zuː
پیٹ‎	peṭ	peːʈ
اندرون‎	andarūn	
گردن‎	gardan	ɡəɾ.d̪ən
پیٹھ‎	pīṭh	
سینه‎	sīnā	
دل‎	dil	d̪ɪl
جگر‎	jigar	d͡ʒɪ.ɡəɾ
پینا‎	pīnā	piː.nɑː
کھانا‎	khānā	kʰɑː.nɑː
کاٹنا‎	kāṭnā	
چوسنا‎	cūsnā	
تھوکنا‎	thūknā	t̪ʰuːk.nɑː
الٹی	ulṭī karnā	ʊl.ʈiː
پهونکنا‎	phū̃knā	
سانس	sā̃ns lenā	sɑːns
ہنسنا‎	hãsnā	ɦə̃s.nɑː
دکھنا‎	dikhnā	
سننا‎	sunnā	sʊn.nɑː
جاننا‎	jānnā	d͡ʒɑːn.nɑː
سوچنا‎	socnā	soːt͡ʃ.nɑː
سونگھنا‎	sū̃ghnā	
ڈرنا‎	ḍarnā	ɖəɾ.nɑː
سونا‎	sonā	suː.nɑː
جینا‎	jīnā	
مرنا‎	marnā	məɾ.nɑː
مارنا‎	mārnā	mɑːɾ.nɑː
لڑنا‎	laṛnā	ləɽ.nɑː
شکار	śikār karnā	ʃɪ.kɑːɾ
مارنا‎	mārnā	mɑːɾ.nɑː
کاٹنا‎	kāṭnā	
بانٹنا‎	bā̃ṭnā	
بهونکنا‎	bhoṅknā	
کهرچنا‎	khuracnā	
کھودنا‎	khodnā	
تیرنا‎	tairnā	t̪ɛːɾ.nɑː
اڑنا‎	uṛnā	ʊɽ.nɑː
چلنا‎	calnā	t͡ʃəl.nɑː
آنا‎	ānā	ɑː.nɑː
لیٹنا‎	leṭnā	leːʈ.nɑː
بیٹھنا‎	baiṭhnā	bɛːʈʰ.nɑː
کھڑا	khaṛā honā	kʰə.ɽɑː
مڑنا‎	muṛnā	
گرنا‎	girnā	ɡɪɾ.nɑː
دینا‎	denā	d̪eː.nɑː
پکڑنا‎	pakaṛnā	
دبانا‎	dabānā	
ملنا‎	malnā	mɪl.nɑː
دھونا‎	dhonā	d̪ʱuː.nɑː
پونچھنا‎	poñchnā	
کھیںچنا‎	khīncnā	
دھکا	dhakkā denā	
پهینکنا‎	pheṅknā	
باندهنا‎	bā̃dhnā	
سینا‎	sīnā	
گننا‎	ginnā	
کہنا‎	kahnā	kəɦ.nɑː
گانا‎	gānā	ɡɑː.nɑː
کهیلنا‎	khelnā	
تیرنا‎	tairnā	t̪ɛːɾ.nɑː
بہنا‎	bahnā	bəɦ.nɑː
جمنا‎	jamnā	
سوجنا‎	sūjnā	
سوراج‎	sūraj	
چاند‎	cānd	t͡ʃɑ̃ːd̪
ستارہ‎	sitārā	sɪ.t̪ɑː.ɾɑː
پانی‎	pānī	pɑː.niː
بارش‎	bāriś	bɑː.ɾɪʃ
دری‎	nadī	d̪ʊ.ɾiː
جھیل‎	jhīl	
سمندر‎	samundar	sə.mʊn.d̪əɾ
نمک‎	namak	nə.mək
پتھر‎	patthar	pət̪.t̪ʰəɾ
ریت‎	ret	ɾeːt̪
دھول‎	dhūl	d̪ʱuːl
زمین‎	zamīn	zə.miːn
بادل‎	bādal	bɑː.d̪əl
دھند‎	dundh	
آسمان‎	āsmān	ɑːs.mɑːn
ہوا‎	havā	ɦuː.ɑː
برف‎	barf	bəɾf
برف‎	barf	bəɾf
دھواں‎	dhūā̃	d̪ʱuː.ɑ̃ː
آگ‎	āg	ɑːɡ
راکھ‎	rākh	ɾɑːkʰ
جلنا‎	jalnā	d͡ʒəl.nɑː
سڑک‎	saṛak	sə.ɽək
پہاڑ‎	pahāṛ	pə.ɦɑːɽ
سرخ‎	surx	sʊɾx
سبز‎	sabz	səbz
پیلا‎	pīlā	
سفید‎	safed	sə.feːd̪
سیاہ‎	siyāh	
رات‎	rāt	ɾɑːt̪
دن‎	din	d̪ɪn
سال‎	sāl	sɑːl
گرم‎	garm	ɡə.ɾəm
سرد‎	sard	
پورا‎	pūrā	puː.ɾɑː
نیا‎	nayā	nə.jɑː
پرانا‎	purānā	
اچھا‎	acchā	ət̪.t͡ʃʰɑː
برا‎	burā	bʊ.ɾɑː
بوسيدہ‎	bosīdāh	
گندا‎	gandā	ɡən.d̪ɑː
سیدھا‎	sīdhā	
گول‎	gol	ɡoːl
تيکها‎	tīkhā	
کند‎	kund	
ہموار‎	hamvār	
گیلا‎	gīlā	ɡiː.lɑː
خشک‎	xuśk	
ٹھیک‎	ṭhīk	
پاس‎	pās	
دور‎	dūr	d̪uːɾ
دایاں‎	dāyā̃	d̪ɑː.jɑ̃ː
بایاں‎	bāyā̃	
پی‎	pe	
میں‎	mẽ	mɛ̃ː
کے	ke sāth	keː
اور‎	aur	ɔːɾ
اگر‎	agar	ə.ɡəɾ
کیونکہ‎	kyūṅki	
نام‎	nām	nɑːm