ⵏⴽⴽ	nkk	
ⴽⵢⵢⵉ	kyyi	
ⵏⵜⵜⴰ	ntta	
ⵏⴽⴽⵏⵉ	nkkni	
ⴽⵏⵏⵉ	knni	
ⵏⵉⵜⵏⵉ	nitni	
ⵡⴰ	wa	
ⵡⴰⵏⵏ	wann	
ⴷⴰ	da	
ⴷⵉⵏ	din	
ⵡⵉ	wi	
ⵎⵉ	mi	
ⵎⴰⵏⵉ	mani	
ⵎⵍⵎⵉ	mlmi	
ⵎⴰⵎⴽ	mamk	
ⵓⵔ	ur	
ⴰⴽⴽⵯ	akkʷ	
ⴰⵟⵟⴰⵚ	aṭṭaṣ	
ⴽⵔⴰ	kra	
ⴷⵔⵓⵙ	drus	
ⵏⵏⵉⴹⵏⵉ	nniḍni	
ⵢⴰⵏ	yan	
ⵙⵉⵏ	sin	
ⴽⵕⴰⴹ	kṛaḍ	
ⴽⴽⵓⵥ	kkuẓ	
ⵙⵎⵎⵓⵙ	smmus	
ⴰⵎⵇⵇⵔⴰⵏ	amqqran	
ⴰⵖⵣⵣⴰⴼ	aɣzzaf	
ⴰⵎⵉⵔⵉⵡ	amiriw	
ⴰⵣⵓⵔⴰⵔ	azurar	
ⴰⵥⴰⵥⴰ	aẓaẓa	
ⴰⵎⵥⵥⵢⴰⵏ	amẓẓyan	
ⴰⴳⵯⵣⵍⴰⵍ	agʷzlal	
ⴰⴽⵕⴰⵥ	akṛaẓ	
ⴰⵙⴷⴰⴷ	asdad	
ⵜⴰⵎⵟⵟⵓⴹⵟ	tamṭṭuḍṭ	
ⴰⵔⴳⴰⵣ	argaz	
ⴰⴼⴳⴰⵏ	afgan	
ⴰⵔⵔⴰⵡ	arraw	
ⵜⴰⵎⵟⵟⵓⴹⵟ	tamṭṭuḍṭ	
ⴰⵔⴳⴰⵣ	argaz	
ⵉⵎⵎⴰ	imma	
ⵉⴱⴱⴰ	ibba	
ⴰⵎⵓⴷⵔ	amudr	
ⴰⵙⵍⵎ	aslm	
ⴰⴳⴹⵉⴹ	agḍiḍ	
ⴰⵢⴷⵉ	aydi	
ⵜⴰⵅⵅⵓⵢⵜ	taxxuyt	
ⴰⴼⵉⵖⵔ	afiɣr	
ⵜⴰⴽⵛⵛⴰ	takcca	
ⴰⴷⴷⴰⴳ	addag	
ⵜⴰⴳⴰⵏⵜ	tagant	
ⴰⵖⵔⵓⵛ	aɣruc	
ⴰⴳⵎⵎⵓ	agmmu	
ⴰⵎⵓⴷ	amud	
ⵜⴰⴼⵔⵜ	tafrt	
ⴰⵥⵓⵕ	aẓuṛ	
ⵉⴼⵔⴽⵉ	ifrki	
ⴰⵊⴷⴷⵉⴳ	ajddig	
ⵜⵓⴳⴰ	tuga	
ⴰⵙⵖⵓⵏ	asɣun	
ⴰⴳⵯⵍⵉⵎ	agʷlim	
ⴰⴽⵙⵓⵎ	aksum	
ⵉⴷⴰⵎⵎⵏ	idammn	
ⵉⵅⵙ	ixs	
ⵜⴰⴷⵓⵏⵜ	tadunt	
ⵜⴰⴳⵍⴰⵢⵜ	taglayt	
ⴰⵛⵛⴰⵡ	accaw	
ⵜⵉⵎⵖⵉⵍⵜ	timɣilt	
ⵓⵊⵏ	ujn	
ⴰⵣⵣⴰⵔ	azzar	
ⵉⵅⴼ	ixf	
ⴰⵎⵣⵣⵓⵖ	amzzuɣ	
ⵜⵉⵟⵟ	tiṭṭ	
ⵜⵉⵏⵣⵔⵜ	tinzrt	
ⴰⵇⵎⵎⵓ	aqmmu	
ⴰⵅⵙ	axs	
ⵉⵍⵙ	ils	
ⴰⵛⵛⴰⵔ	accar	
ⴰⴹⴰⵕ	aḍaṛ	
ⴰⴹⴰⵕ	aḍaṛ	
ⴰⴼⵓⴷ	afud	
ⴰⴼⵓⵙ	afus	
ⴰⴼⵔ	afr	
ⴰⴷⵉⵙ	adis	
ⴰⴷⴰⵏ	adan	
ⴰⵎⴳⴳⵕⴹ	amggṛḍ	
ⴰⴽⵔⵓⵎ	akrum	
ⴰⴷⵎⵔ	admr	
ⵓⵍ	ul	
ⵜⴰⵙⴰ	tasa	
ⵙⵓ	su	
ⵛⵛ	cc	
ⵖⴱⴱⵉ	ɣbbi	
ⵙⵙⵓⵎⵎ	ssumm	
ⵙⵙⵓⴼⵙ	ssufs	
ⴰⵔⵔ	arr	
ⵙⵓⴹ	suḍ	
ⵙⵓⵏⴼⵙ	sunfs	
ⴹⵚⵚⴰ	ḍṣṣa	
ⵥⵕ	ẓṛ	
ⵙⵍⵍ	sll	
ⵙⵙⵏ	ssn	
ⵖⴰⵍ	ɣal	
ⴽⴹⵓ	kḍu	
ⴳⴳⵯⴷ	ggʷd	
ⵟⵟⵚ	ṭṭṣ	
ⴷⴷⵔ	ddr	
ⵎⵎⵜ	mmt	
ⵏⵖ	nɣ	
ⵎⵎⴰⵖ	mmaɣ	
ⴳⵎⵔ	gmr	
ⵓⵜ	ut	
ⴱⴱⵉ	bbi	
ⴼⵅⵙ	fxs	
ⴱⴱⵥ	bbẓ	
ⴽⵎⵣ	kmz	
ⵖⵣ	ɣz	
ⵛⵛⴼ	ccf	
ⴰⴼⴳ	afg	
ⴷⴷⵓ	ddu	
ⴰⵙ	as	
ⴳⵏ	gn	
ⵇⵇⵉⵎ	qqim	
ⴱⴷⴷ	bdd	
ⵏⵏⴹ	nnḍ	
ⴹⵕ	ḍṛ	
ⴼⴽ	fk	
ⴰⵎⵥ	amẓ	
ⵥⵎ	ẓm	
ⴰⵎⵙ	ams	
ⵙⵙⵉⵔⴷ	ssird	
ⵙⵙⴼⴹ	ssfḍ	
ⴰⵡⴽ	awk	
ⴷⵃⵉ	dḥi	
ⴳⵔ	gr	
ⵇⵇⵏ	qqn	
ⴳⵏⵓ	gnu	
ⵙⵙⵉⴹⵏ	ssiḍn	
ⵉⵏⵉ	ini	
ⵉⵔⵉⵔ	irir	
ⵓⵔⴰⵔ	urar	
ⴰⵢⵡⵓⵍ	aywul	
ⴰⵣⵣⵍ	azzl	
ⴳⵔⵙ	grs	
ⴰⴼⴼ	aff	
ⵜⴰⴼⵓⴽⵜ	tafukt	
ⵜⵉⵣⵉⵔⵉ	tiziri	
ⵉⵜⵔⵉ	itri	
ⴰⵎⴰⵏ	aman	
ⴰⵏⵥⴰⵕ	anẓaṛ	
ⴰⵙⵉⴼ	asif	
ⴰⴳⵍⵎⴰⵎ	aglmam	
ⵉⵍⵍ	ill	
ⵜⵉⵙⵏⵜ	tisnt	
ⴰⵥⵕⵓ	aẓṛu	
ⵉⵊⴷⵉ	ijdi	
ⴰⴳⴷⵕⵓⵕ	agḍṛuṛ	
ⴰⴽⴰⵍ	akal	
ⴰⵎⴷⵍⵓ	amdlu	
ⵜⴰⴳⵓⵜ	taggut	
ⴰⵊⵏⵏⴰ	ajnna	
ⴰⴹⵓ	aḍu	
ⴰⴷⴼⵍ	adfl	
ⴰⴳⵔⵉⵙ	agris	
ⴰⴳⴳⵓ	aggu	
ⵜⵉⵎⵙⵙⵉ	timssi	
ⵉⵖⴷ	iɣd	
ⵔⵖ	rɣ	
ⴰⴱⵔⵉⴷ	abrid	
ⴰⴷⵔⴰⵔ	adrar	
ⴰⵣⴳⴳⵯⴰⵖ	azggʷaɣ	
ⴰⵣⴳⵣⴰⵡ	azgzaw	
ⴰⵡⵔⴰⵖ	awraɣ	
ⴰⵎⵍⵍⴰⵍ	amllal	
ⴰⴱⵔⴽⴰⵏ	abrkan	
ⵉⴹ	iḍ	
ⴰⵙⵙ	ass	
ⴰⵙⴳⴳⵯⴰⵙ	asggʷas	
ⵉⵎⵖⵉ	imɣi	
ⴰⵚⵎⵎⵉⴹ	aṣmmiḍ	
ⴰⵎⴽⵜⵓⵔ	amktur	
ⴰⵎⴰⵢⵏⵓ	amaynu	
ⴰⵡⵙⵙⴰⵔ	awssar	
ⴰⵇⴰⴷⴷⴰⴷ	aqaddad	
ⴰⵎⵛⵓⵎ	amcum	
ⴰⵎⵔⵛⵓ	amrcu	
ⴰⵎⵔⴽⵓ	amrku	
ⴰⵣⵔⴼ	azrf	
ⵜⴰⵇⵓⵔⵉⵔⵜ	taqurirt	
ⴰⵎⵙⴷ	amsd	
ⴳⵍⵎ	glm	
ⴰⵎⵍⵡⴰⵖ	amlwaɣ	
ⴱⵣⴳ	bzg	
ⴰⵇⵓⵔⴰⵔ	aqurar	
ⵓⴽⵕⵉⵥ	ukṛiẓ	
ⴰⵏⴽⵎⴰⵔ	ankmar	
ⵡⴰⵀⵍⵉ	wahli	
ⴰⴼⴰⵙⵉ	afasi	
ⴰⵥⵍⵎⴰⴹ	aẓlmaḍ	
ⵖⵔ	ɣr	
ⴷⴳ	dg	
ⴰⴽⴷ	akd	
ⴷ	d	
ⵉⵖ	iɣ	
ⴰⵛⴽⵓ	acku	
ᴬᴿⵉⵙⵎ	ism	