أنا‎	ʔana	ˈʔa.na
إنت‎	ʔinta	ˈʔin.ta
هو‎	huwwe	ˈhuw.we
إحنا‎	ʔiḥna	ˈʔiħ.na
إنتو‎	ʔintu	ˈʔin.tu
هم‎	humme	ˈhum.me
هاد‎	hād	ˈhaːd
هداك‎	hadāk	haˈdaːk
هون‎	hōn	ˈhoːn
هناك‎	hunāk	huˈnaːk
مين‎	mīn	miːn
إيش‎	ʔēš	ˈʔeːʃ
وين‎	wēn	weːn
إيمتى‎	ʔēmta	ˈʔeːm.ta
كيف‎	kīf	kiːf
مُش‎	muš	muʃ
كل‎	kull	ˈkull
كتير‎	ktīr	ˈktiːr
بعض‎	baʕḍ	ˈbaʕdˤ
شوي‎	šway	ˈʃwaj
تاني‎	tāni	ˈtaː.ni
واحد‎	wāḥad	ˈwaː.ħad
تنين‎	tnēn	tneːn
تلاتة‎	talāte	taˈlaː.te
أربعة‎	ʔarbaʕa	ˈʔar.ba.ʕa
خمسة‎	ḵamse	ˈxam.se
كبير‎	kbīr	ˈkbiːr
طويل‎	ṭwīl	ˈtˤwiːl
واسع‎	wāsiʕ	ˈwaː.siʕ
خميل‎	ḵmīl	ˈxmiːl
تقيل‎	tʔīl	ˈtʔiːl
زغير‎	zḡīr	ˈzɣiːr
قصير‎	ʔaṣīr	ʔaˈsˤiːr
ديّق‎	dijjiʔ	ˈdij.jiʔ
رفيع‎	rfīʕ	ˈrfiːʕ
مرة‎	mara	ˈma.ra
زلمة‎	zalame	ˈza.la.me
إنسان‎	ʔinsān	ˈʔin.saːn
ولد‎	walad	ˈwa.lad
مرة‎	mara	ˈma.ra
جوز‎	jōz	ˈʒoːz
إم‎	ʔimm	ʔimm
أب‎	ʔabb	ʔabb
حيوان‎	ḥaywān	ħajˈwaːn
سمكة‎	samake	ˈsa.ma.ke
عصفور‎	ʕaṣfūr	ʕasˤˈfuːr
كلب‎	kalb	ˈkalb
قملة‎	ʔamle	ˈʔam.le
حية‎	ḥajje	ˈħaj.je
دودة‎	dūde	ˈduː.de
شجرة‎	šajara	ˈʃa.ʒa.ra
غابة‎	ḡābe	ˈɣaː.be
عصاي‎	ʕaṣāy	ʕaˈsˤaːj
فاكهة‎	fākha	ˈfaːk.ha
بذرة‎	bizre	ˈbiz.re
ورقة‎	waraʔa	ˈwa.ra.ʔa
شرش‎	širš	ˈʃirʃ
قشرة‎	ʔišre	ˈʔiʃ.re
زهرة‎	zahra	ˈzah.ra
حشيش‎	ḥašīš	ħaˈʃiːʃ
حبل‎	ḥabil	ˈħa.bil
جلد‎	jild	ˈʒild
لحم‎	laḥm	ˈlaħm
دم‎	damm	ˈdamm
عضم‎	ʕaḍm	ˈʕadˤm
شحم‎	šaḥm	ˈʃaħm
بيض‎	bēḍa	ˈbeːdˤ
قرن‎	ʔarn	ˈʔarn
دنب‎	danab	ˈda.nab
ريش‎	rīše	ˈriːʃ
شعر‎	šaʕr	ˈʃaʕr
راس‎	rās	ˈraːs
دان‎	dān	ˈdaːn
عين‎	ʕēn	ˈʕeːn
منخار‎	munḵār	munˈxaːr
تم‎	tumm	ˈtumm
سن‎	sinn	ˈsinn
لسان‎	lsān	ˈlsaːn
أضفر‎	ʔuḍfar	ˈʔudˤ.far
إجر‎	ʔijr	ˈʔiʒr
ساق‎	sāʔ	ˈsaːʔ
ركبة‎	rukbe	ˈruk.be
إيد‎	ʔīd	ˈʔiːd
جناح‎	janāḥ	ʒaˈnaːħ
بطن‎	baṭn	ˈbatˤn
مصران‎	muṣrān	musˤˈraːn
رقبة‎	raʔabe	ˈra.ʔa.be
ضهر‎	ḍahr	ˈdˤahr
صدر‎	ṣidr	ˈsˤidr
قلب‎	ʔalb	ˈʔalb
كبدة‎	kibde	ˈkib.de
شرب‎	širib	ˈʃi.rib
أكل‎	ʔakal	ˈʔa.kal
عض‎	ʕaḍḍ	ˈʕadˤdˤ
مص‎	maṣṣ	ˈmasˤsˤ
بزق‎	bazaʔ	ˈba.zaʔ
نتق‎	nataʔ	ˈna.taʔ
نفخ‎	nafaḵ	ˈna.fax
تنفس‎	tnaffas	ˈtnaf.fas
ضحك‎	ḍiḥik	ˈdˤi.ħik
شاف‎	šāf	ˈʃaːf
سمع‎	simiʕ	ˈsi.miʕ
عرف‎	ʕirif	ˈʕirif
فكر‎	fakkar	ˈfak.kar
شم‎	šamm	ˈʃamm
خاف‎	ḵāf	ˈxaːf
نام‎	nām	ˈnaːm
عاش‎	ʕāš	ˈʕaːʃ
مات‎	māt	ˈmaːt
قتل‎	ʔatal	ˈʔa.tal
تخانق‎	tḵānaʔ	ˈtxaː.naʔ
تصيد‎	tṣayyad	ˈtsˤaj.jad
ضرب‎	ḍarab	ˈdˤa.rab
قطع‎	ʔaṭṭaʕ	ˈʔatˤ.tˤaʕ
شق‎	šaʔʔ	ˈʃaʔʔ
طعن‎	ṭaʕan	ˈtˤa.ʕan
حك‎	ḥakk	ˈħakk
حفر‎	ḥafar	ˈħa.far
سبح‎	sibiḥ	ˈsi.biħ
طار‎	ṭār	ˈtˤaːr
مشى‎	maša	ˈma.ʃa
إجا‎	ʔija	ˈʔi.ʒa
نام‎	nām	ˈnaːm
قعد‎	ʔaʕad	ˈʔa.ʕad
وقف‎	waʔʔaf	ˈwaʔ.ʔaf
لف‎	laff	ˈlaff
وقع‎	wiʔiʕ	ˈwi.ʔiʕ
أعطى‎	ʔaʕṭa	ˈʔaʕ.tˤa
مسك‎	misik	ˈmi.sik
عصر‎	ʕaṣar	ˈʕa.sˤar
فرك‎	farak	ˈfa.rak
غسل‎	ḡasal	ˈɣa.sal
مسح‎	masaḥ	ˈma.saħ
سحب‎	saḥab	ˈsa.ħab
دفش‎	dafaš	ˈda.faʃ
رمى‎	rama	ˈra.ma
ربط‎	rabaṭ	ˈra.batˤ
خيّط‎	ḵayyaṭ	ˈxaj.jatˤ
عد‎	ʕadd	ˈʕadd
قال‎	ʔāl	ˈʔaːl
غنى‎	ḡanna	ˈɣan.na
لعب‎	liʕib	ˈli.ʕib
طاش‎	ṭāš	ˈtˤaːʃ
سال‎	sāl	ˈsaːl
صقع‎	ṣaʔʔaʕ	ˈsˤaʔ.ʔaʕ
ورم‎	wirim	ˈwi.rim
شمس‎	šams	ˈʃams
قمر‎	ʔamar	ˈʔa.mar
نجمة‎	nijme	ˈniʒ.me
مي‎	ṃajj	ˈmˤajj
شتا‎	šita	ˈʃi.ta
نهر‎	nahr	ˈnahr
بحيرة‎	buḥayra	buˈħaj.ra
بحر‎	baḥar	ˈba.ħar
ملح‎	malḥ	ˈmalħ
حجر‎	ḥajar	ˈħa.ʒar
رمل‎	raml	ˈraml
غبرة‎	ḡabara	ˈɣa.ba.ra
أرض‎	ʔarḍ	ˈʔardˤ
غيم‎	ḡēm	ˈɣeːm
ضباب‎	ḍabāb	dˤaˈbaːb
سما‎	sama	ˈsa.ma
هوا‎	hawa	ˈħa.wa
تلج‎	talj	ˈtalʒ
تلج‎	talj	ˈtalʒ
دخان‎	duḵḵān	duxˈxaːn
نار‎	nār	ˈnaːr
رماد‎	ramād	raˈmaːd
حرق‎	ḥaraʔ	ˈħa.raʔ
طريق‎	ṭarīʔ	tˤaˈriːʔ
جبل‎	jabal	ˈʒa.bal
أحمر‎	ʔaḥmar	ˈʔaħ.mar
أخضر‎	ʔaḵḍar	ˈʔax.dˤar
أصفر‎	ʔaṣfar	ˈʔasˤ.far
أبيض‎	ʔabyaḍ	ˈʔab.jadˤ
أسود‎	ʔaswad	ˈʔas.wad
ليلة‎	lēle	ˈleː.le
يوم‎	yōm	ˈjoːm
سنة‎	sane	ˈsa.ne
سخن‎	suḵn	ˈsuxn
بارد‎	bārid	ˈbaː.rid
ملان‎	malān	maˈlaːn
جديد‎	jdīd	ˈʒdiːd
قديم‎	ʔadīm	ʔaˈdiːm
منيح‎	mnīḥ	ˈmniːħ
عاطل‎	ʕāṭil	ˈʕaː.tˤil
خربان‎	ḵarbān	xarˈbaːn
وسخ‎	wisiḵ	ˈwi.six
دغري‎	duḡri	ˈduɣ.ri
مدوّر‎	mdawwar	ˈmdaw.war
ماضي‎	māḍi	ˈmaː.dˤi
بارد‎	bārid	ˈbaː.rid
ناعم‎	nāʕim	ˈnaː.ʕim
مبلول‎	mablūl	mabˈluːl
ناشف‎	nāšif	ˈnaː.ʃif
صح‎	saḥḥ	ˈsˤaħħ
قريب‎	ʔarīb	ʔaˈriːb
بعيد‎	bʕīd	ˈbʕiːd
يمين‎	yamīn	jaˈmiːn
شمال‎	šmāl	ˈʃmaːl
عند‎	ʕind	ˈʕind
في‎	fi	fi
مع‎	maʕ	maʕ
و‎	w-	wa
لو‎	law	law
عشان‎	ʕašān	ʕaˈšaːn
اسم‎	ʔism	ˈʔism