𐬀𐬰𐬇𐬨‎	azə̄m	
𐬙𐬏𐬨‎	tūm	
		
		
		
		
𐬀𐬌𐬌𐬇𐬨‎‎	aiiə̄m‎	
		
		
		
		
		
		
		
		
		
𐬬𐬍𐬯𐬞𐬀‎	vīspa	
		
		
		
		
𐬀𐬉𐬎𐬎𐬀‎	aēuua	
𐬛𐬎𐬎𐬀‎‎	duua‎	
𐬚𐬭𐬌‎‎	θri‎	θri
𐬗𐬀𐬚𐬡𐬀𐬭‎‎	caθβar‎	
𐬞𐬀𐬧𐬗𐬀‎‎	paṇca‎	
𐬨𐬀𐬰𐬀‎	maza	
𐬛𐬀𐬭𐬆𐬔𐬀‎‎	darəga‎	
𐬞𐬆𐬭𐬆𐬚𐬎‎	pərəθu	
		
		
		
		
		
		
		
		
		
		
		
		
		
		
		
		
𐬬𐬀𐬌𐬌‎	vaii	
𐬯𐬞𐬀𐬥‎	span	
		
		
		
		
		
		
		
		
		
		
		
		
		
		
		
		
𐬬𐬊𐬵𐬎𐬥𐬍‎	vohunī	
𐬀𐬯𐬙‎	ast	
		
𐬀𐬉𐬨‎	aēm	
		
		
		
		
		
𐬔𐬀𐬊𐬱𐬀‎	gaoša	
𐬀𐬱𐬌‎	aši	
		
		
		
		
		
		
		
		
		
		
𐬎𐬛𐬀𐬭𐬀‎	udara	
		
		
𐬞𐬀𐬭𐬱𐬙𐬀‎‎	paršta‎	
𐬬𐬀𐬭𐬀𐬵‎	varah	
		
		
𐬓𐬀𐬭𐬀𐬌𐬙𐬌‎	xᵛaraiti	
		
		
		
		
		
𐬬𐬁𐬌𐬙𐬌‎	vāiti	
		
		
		
		
		
		
		
		
		
		
𐬌𐬭𐬌𐬚𐬌𐬌𐬈𐬌𐬙𐬌‎	iriθiieiti	
		
		
		
		
𐬐𐬆𐬭𐬆𐬥𐬙𐬀𐬌𐬙𐬌‎	kərəntaiti	
		
		
		
𐬐𐬀𐬥-‎	kan-	
		
		
		
		
		
		
		
		
		
		
		
		
		
		
		
		
		
		
		
		
		
		
		
		
		
		
		
		
		
		
		
		
		
		
		
		
		
		
		
𐬞𐬄𐬯𐬥𐬎‎‎	pąsnu‎	
𐬰𐬀𐬨‎‎	zam‎	
𐬨𐬀𐬉𐬖𐬀‎	maēγa	
		
		
		
		
		
		
		
𐬁𐬙𐬭𐬌𐬌𐬀‎	ātriia	
𐬛𐬀𐬲𐬌𐬌𐬈𐬙𐬈‎	dažiiete	
		
		
		
		
		
		
𐬯𐬁𐬨𐬀‎	sāma	
		
𐬀𐬌𐬌𐬀𐬭‎	aiiar	
		
		
𐬯𐬀𐬭𐬆𐬙𐬀‎	sarəta	
		
		
		
		
𐬀𐬐𐬀‎	aka	
		
𐬁𐬵𐬍𐬙𐬀‎	āhīta	
		
		
		
		
		
		
𐬵𐬎𐬱𐬐𐬀‎	huška	
		
		
		
		
		
		
		
		
𐬗𐬀‎	ca	
		
𐬰𐬍‎	zī	
		