eme	eme	
obɛ	obɛ	
yɛ	yɛ	
besu	besu	
benu	benu	
bɔ	bɔ	
ambe	ambe	
ambɔ	ambɔ	
oani	oani	
koni	koni	
ani	ani	
sina	sina	
sua	sua	
mbenɔ nde	mbenɔ nde	
		
-nao-	-nao-	
bɔbhi	bɔbhi	
kpuu	kpuu	
buambo	buambo	
		
angbo	angbo	
moti	moti	
babɛ	babɛ	
basaɔ	basaɔ	
gena	gena	
bɔku	bɔku	
angbo	angbo	
aende	aende	
-gbae	-gbae	
-tete	-tete	
adoko	adoko	
abhɔa	abhɔa	
-ngbi	-ngbi	
		
-nyɛbɛ	-nyɛbɛ	
nke	nke	
moko	moko	
nkpa	nkpa	
miki	miki	
nka	nka	
munya	munya	
mma	mma	
abhɛ	abhɛ	
nyama	nyama	
su	su	
mbu	mbu	
mbɔa	mbɔa	
bamba	bamba	
njɔka	njɔka	
nyɔmbɔ	nyɔmbɔ	
me	me	
nkanda	nkanda	
ɛsɛndɛ	ɛsɛndɛ	
mpua	mpua	
mbuka	mbuka	
kasa	kasa	
migi	migi	
kekoba	kekoba	
		
ɔphɔ	ɔphɔ	
ngoi	ngoi	
nkeke	nkeke	
kisuku	kisuku	
magia	magia	
nkua	nkua	
mua	mua	
eke	eke	
ndeka	ndeka	
nkondo	nkondo	
		
seka	seka	
mɔ	mɔ	
ketue	ketue	
iso	iso	
		
aphe-nɔkɔ	aphe-nɔkɔ	
minyɔ	minyɔ	
edaka	edaka	
caa	caa	
ecinji	ecinji	
ecinji	ecinji	
moanku	moanku	
njaga	njaga	
		
sɔphɔ	sɔphɔ	
mɛla	mɛla	
kingo	kingo	
ngɔngɔ	ngɔngɔ	
ɛbɛ	ɛbɛ	
mema	mema	
ebae	ebae	
-noa	-noa	
-ea	-ea	
-gɔta	-gɔta	
-muma	-muma	
-sua	-sua	
-ɔka	-ɔka	
		
-phɛkuma	-phɛkuma	
-tɛbha	-tɛbha	
-ɔna	-ɔna	
-ɔka	-ɔka	
-ubha	-ubha	
-kanisia	-kanisia	
-umbí	-umbí	
-banga	-banga	
-da	-da	
-enda	-enda	
-kua	-kua	
-moa	-moa	
-mana	-mana	
-ta	-ta	
-bɛta	-bɛta	
-gɔta	-gɔta	
-bhoma	-bhoma	
-tusa	-tusa	
-dua	-dua	
-tongea	-tongea	
-ɔga	-ɔga	
-yaa	-yaa	
-tamba	-tamba	
-bhika	-bhika	
-bonda	-bonda	
-ika	-ika	
-mama	-mama	
-kendua	-kendua	
-gua	-gua	
-opha	-opha	
sukia	sukia	
-sɛdisa	-sɛdisa	
-tia	-tia	
-sokosa	-sokosa	
-kɔmbɛa	-kɔmbɛa	
-ututua	-ututua	
-tiba	-tiba	
-maka	-maka	
-boa	-boa	
-phopha	-phopha	
-tanga	-tanga	
yɔnga	yɔnga	
-emba	-emba	
-njokoa	-njokoa	
-phoba	-phoba	
-dhidha	-dhidha	
		
-bimba	-bimba	
mani	mani	
songe	songe	
sɛɛngɔa	sɛɛngɔa	
ibo	ibo	
mbua	mbua	
ɔba	ɔba	
etuu	etuu	
obenge	obenge	
mɔnɛi	mɔnɛi	
etae	etae	
mbume	mbume	
gbɛɛkɛsɛ	gbɛɛkɛsɛ	
nsɔdɔ	nsɔdɔ	
egugu	egugu	
ebundu	ebundu	
ego	ego	
maiphianɔ	maiphianɔ	
		
ibo adhɛdhɛ	ibo adhɛdhɛ	
maki	maki	
nsa	nsa	
ebhu	ebhu	
-sida	-sida	
aphe	aphe	
mamba	mamba	
otana	otana	
		
		
abhu	abhu	
-phiphi	-phiphi	
kipha	kipha	
esa	esa	
saga	saga	
ajo	ajo	
adhɛdhɛ	adhɛdhɛ	
áotuma	áotuma	
andende	andende	
ngbɛga	ngbɛga	
anja	anja	
ajede	ajede	
		
nkiki	nkiki	
		
mpɛ	mpɛ	
aophea	aophea	
		
gbɛdɛmana	gbɛdɛmana	
dhɛka	dhɛka	
ɔma	ɔma	
doni	doni	
bhibhi	bhibhi	
danga	danga	
		
		
na	na	
		
n’	n’	
n’	n’	
ambe	ambe	
ka nyɔngɔ nde	ka nyɔngɔ nde	
ina	ina	