nna	nna	
o	o	
a	a	
rena	rena	
lena	lena	
ba	ba	
bjô	bjô	
bjôo	bjôo	
fano	fano	
falê	falê	
mang	mang	
ene	ene	
kae	kae	
neng	neng	
bjang	bjang	
se	se	
aohle	aohle	
-ntšhi	-ntšhi	
-ngwê	-ngwê	
mmalwa	mmalwa	
mangwê	mangwê	
ntowe	ntowe	
pêdi	pêdi	
tharo	tharo	
nnê	nnê	
tlhano	tlhano	
-golo	-golo	
-lêlê	-lêlê	
-phara	-phara	
-koto	-koto	
-fala	-fala	
-nyane	-nyane	
-huswane	-huswane	
sêsane	sêsane	
-ôtilê	-ôtilê	
mosadi	mosadi	
monna	monna	
semotho	semotho	
ngwana	ngwana	
mogatša	mogatša	
monna	monna	
mma	mma	
papa	papa	
phôôfôlô	phôôfôlô	
hlapi	hlapi	
nônyana	nônyana	
mpša	mpša	
nta	nta	
nôga	nôga	
seboko	seboko	
sehlare	sehlare	
letši	letši	
thupa	thupa	
diênywa	diênywa	
pêu	pêu	
lehlare	lehlare	
modu	modu	
lekgata	lekgata	
lebue	lebue	
bjang	bjang	
mogala	mogala	
letlalô	letlalô	
nama	nama	
madi	madi	
lešapô	lešapô	
makhura	makhura	
lee	lee	
lenaka	lenaka	
mosela	mosela	
lefofa	lefofa	
moriri	moriri	
hlôgô	hlôgô	
tsêbê	tsêbê	
leihlô	leihlô	
nkô	nkô	
molômo	molômo	
leinô	leinô	
leleme	leleme	
nala	nala	
leoto	leoto	
moômo	moômo	
khuru	khuru	
letsôgô	letsôgô	
lefêgô	lefêgô	
lešôrô	lešôrô	
dikatêng	dikatêng	
molala	molala	
mokôkôtlô	mokôkôtlô	
letswêlê	letswêlê	
pelo	pelo	
sebete	sebete	
nwa	nwa	
ja	ja	
loma	loma	
monya	monya	
tshwa	tshwa	
hlatša	hlatša	
foka	foka	
phefomola	phefomola	
sêga	sêga	
bôna	bôna	
kwa	kwa	
tseba	tseba	
nagana	nagana	
fofonêla	fofonêla	
tšhabô	tšhabô	
rôbala	rôbala	
phela	phela	
hwa	hwa	
bolaya	bolaya	
lwa	lwa	
tsoma	tsoma	
bêtha	bêtha	
bêtla	bêtla	
farola	farola	
hlaba	hlaba	
ngwapa	ngwapa	
êpa	êpa	
sêsa	sêsa	
fofa	fofa	
sepela	sepela	
tla	tla	
awêla	awêla	
itulêla	itulêla	
êma	êma	
hlabologa	hlabologa	
wa	wa	
fa	fa	
swara	swara	
pitlêla	pitlêla	
pikitla	pikitla	
hlape	hlape	
hlakola	hlakola	
gôga	gôga	
sukumêtša	sukumêtša	
akga	akga	
bôfa	bôfa	
roka	roka	
bala	bala	
bolêla	bolêla	
êpêla	êpêla	
bapala	bapala	
kôkôbala	kôkôbala	
êla	êla	
		
ruruga	ruruga	
letšatši	letšatši	
kgwêdi	kgwêdi	
nalêdi	nalêdi	
mêêtse	mêêtse	
pula	pula	
noka	noka	
letsha	letsha	
lewatlê	lewatlê	
letswai	letswai	
lentswê	lentswê	
lehlabathe	lehlabathe	
lerole	lerole	
mobu	mobu	
leru	leru	
mogodi	mogodi	
legodimo	legodimo	
môya	môya	
lehlwa	lehlwa	
lekgwa	lekgwa	
muši	muši	
mollô	mollô	
melôra	melôra	
fiša	fiša	
tsela	tsela	
thaba	thaba	
-hubêdu	-hubêdu	
-tala	-tala	
-sêhla	-sêhla	
-šwêu	-šwêu	
-so	-so	
bošego	bošego	
mohla	mohla	
ngwaga	ngwaga	
-futhumêla	-futhumêla	
-serame	-serame	
-tlêtše	-tlêtše	
-fsa	-fsa	
-golo	-golo	
-tle	-tle	
-be	-be	
bodilê	bodilê	
ditšhila	ditšhila	
ôtlologa	ôtlologa	
potokô	potokô	
bogale	bogale	
kubêga	kubêga	
borêlêdi	borêlêdi	
kôlôba	kôlôba	
-ômiša	-ômiša	
nêpiša	nêpiša	
gaufsi	gaufsi	
kgolê	kgolê	
lagoja	lagoja	
lengêlê	lengêlê	
fa	fa	
go	go	
na	na	
le	le	
ga	ga	
gobane	gobane	
lebitšô	lebitšô	