mimi	mimi	
wewe	wewe	
yeye	yeye	
sisi	sisi	
ninyi	ninyi	
wao	wao	
huyu	huyu	
lile	lile	
hapa	hapa	
hapo	hapo	
nani	nani	
nini	nini	
wapi	wapi	
lini	lini	
vipi	vipi	
si	si	
-ote	-ote	
-ingi	-ingi	
baadhi ya	baadhi ya	
kidogo	kidogo	
-ingine	-ingine	
moja	moja	
mbili	mbili	
tatu	tatu	
nne	nne	
tano	tano	
-kubwa	-kubwa	
-refu	-refu	
-pana	-pana	
-nene	-nene	
-zito	-zito	
-dogo	-dogo	
-fupi	-fupi	
-embamba	-embamba	
-embamba	-embamba	
mwanamke	mwanamke	
mwanamume	mwanamume	
mtu	mtu	
mtoto	mtoto	
mke	mke	
mume	mume	
mama	mama	
baba	baba	
mnyama	mnyama	
samaki	samaki	
ndege	ndege	ˈⁿdɛ.ɠɛ
mbwa	mbwa	
chawa	chawa	
nyoka	nyoka	ˈɲɔ.kɑ
mnyoo	mnyoo	
mti	mti	
msitu	msitu	
fimbo	fimbo	
tunda	tunda	
mbegu	mbegu	
jani	jani	
mzizi	mzizi	
gamba	gamba	
ua	ua	
nyasi	nyasi	
kamba	kamba	
ngozi	ngozi	ˈŋɡɔ.zi
nyama	nyama	
damu	damu	
mfupa	mfupa	
mafuta	mafuta	mɑˈfut.ɑ
yai	yai	
pembe	pembe	
mkia	mkia	
unyoya	unyoya	
nywele	nywele	
kichwa	kichwa	
sikio	sikio	
jicho	jicho	
pua	pua	
kinywa	kinywa	
jino	jino	
ulimi	ulimi	
ukucha	ukucha	
mguu	mguu	
mguu	mguu	
goti	goti	
mkono	mkono	
ubawa	ubawa	
tumbo	tumbo	
utumbo	utumbo	
shingo	shingo	
mgongo	mgongo	
ziwa	ziwa	ˈzi.wɑ
moyo	moyo	
ini	ini	
kunywa	kunywa	
-la	-la	
-uma	-uma	
-fyonza	-fyonza	
-tema	-tema	
-tapika	-tapika	
		
-pumua	-pumua	
-cheka	-cheka	
-ona	-ona	
-sikia	-sikia	
-jua	-jua	
-waza	-waza	
-nusa	-nusa	
-ogopa	-ogopa	
-lala	-lala	
-ishi	-ishi	
-fa	-fa	
-ua	-ua	
-pigana<	-pigana<	
-winda	-winda	
-piga	-piga	
-kata	-kata	
-pasua	-pasua	
-choma	-choma	
-kuna	-kuna	
-chimba	-chimba	
-ogelea	-ogelea	
-paa	-paa	
-tembea	-tembea	
-ja	-ja	
-gona	-gona	
-keti	-keti	
-simama	-simama	
-pindua	-pindua	
-anguka	-anguka	
-pa	-pa	
-shika	-shika	
-kaba	-kaba	
-sugua	-sugua	
-osha	-osha	
-futa	-futa	
-vuta	-vuta	
-sukuma	-sukuma	
-tupa	-tupa	
-funga	-funga	
-shona	-shona	
-wanga	-wanga	
-sema	-sema	
-imba	-imba	
-cheza	-cheza	
-elea	-elea	
-tiririka	-tiririka	
-ganda	-ganda	
-fura	-fura	
jua	jua	
mwezi	mwezi	
nyota	nyota	
maji	maji	
mvua	mvua	
mto	mto	
ziwa	ziwa	ˈzi.wɑ
bahari	bahari	
chumvi	chumvi	
jiwe	jiwe	
mchanga	mchanga	
vumbi	vumbi	
ardhi	ardhi	
wingu	wingu	
ukungu	ukungu	
uwingu	uwingu	
upepo	upepo	
theluji	theluji	
barafu	barafu	
moshi	moshi	
moto	moto	
majivu	majivu	
-waka	-waka	
njia	njia	
mlima	mlima	
-ekundu	-ekundu	
kijani	kijani	
manjano	manjano	
-eupe	-eupe	
-eusi	-eusi	
usiku	usiku	
siku	siku	
mwaka	mwaka	
moto	moto	
baridi	baridi	
-jaa	-jaa	
-pya	-pya	
-zee	-zee	
-ema	-ema	
-baya	-baya	
-bovu	-bovu	
-chafu	-chafu	
-nyofu	-nyofu	
-duara	-duara	
-kali	-kali	
dugi	dugi	
-laini	-laini	
-nyevu	-nyevu	
-kavu	-kavu	
sahihi	sahihi	
karibu	karibu	
mbali	mbali	
kuume	kuume	
kushoto	kushoto	
pa	pa	
bi	bi	
na	na	nɑ
na	na	nɑ
kama	kama	
kwa kuwa	kwa kuwa	
jina	jina	