ma	ma	
nga	nga	
mu	mu	
nu	nu	
ngeen	ngeen	
ñu	ñu	
lii	lii	
lele	lele	
fi	fi	
fa	fa	
kan	kan	
lan	lan	
ana	ana	ˈa.na
kañ	kañ	
naka	naka	ˈnaka
du	du	
lëpp	lëpp	
		
ay	ay	
tuuti	tuuti	
beneen	beneen	
benna	benna	
ñaar	ñaar	
ñetta	ñetta	
ñenent	ñenent	
juróom	juróom	
mag	mag	
		
		
		
		
ndaw	ndaw	
gatt	gatt	
		
sew	sew	
jigéen	jigéen	
góor	góor	
nit	nit	
xale	xale	ˈxalɛ
jabar	jabar	
jëkkër	jëkkër	
yaay	yaay	
baay	baay	
rab	rab	
jën	jën	ɟən
picca	picca	
xaj	xaj	xaɟ
teen	teen	
jaan	jaan	
saan	saan	
garab	garab	
		
		
		
		
		
		
		
		
nax	nax	
		
der	der	
yaapa	yaapa	
		
		
		
nen	nen	
		
		
		
kawar	kawar	
boopa	boopa	
noppa	noppa	ˈnɔpːa
bet	bet	
baken	baken	
gemmiñ	gemmiñ	
boñ	boñ	
laameñ	laameñ	
		
		
tanka	tanka	
óom	óom	
loxo	loxo	
ngelaw	ngelaw	
biir	biir	
		
baat	baat	
ganaw	ganaw	
		
		
		
naan	naan	
lekka	lekka	
maata	maata	
		
		
woccu	woccu	
		
		
		
gis	gis	
dégg	dégg	
xam	xam	
xalaat	xalaat	
		
		
nelaw	nelaw	
		
		
		
		
róbba	róbba	
		
dog	dog	
		
		
		
gas	gas	
feey	feey	
		
dem	dem	
ñëw	ñëw	
tedda	tedda	
toog	toog	
taxaw	taxaw	
		
		
jox	jox	
		
		
		
raxas	raxas	
fompa	fompa	
		
		
		
		
ñaw	ñaw	
lim	lim	
wax	wax	
woy	woy	
fo	fo	
		
		
		
		
naaj	naaj	
weer	weer	
		
ndox	ndox	ndɔx
		
		
		
geej	geej	
xorom	xorom	
xeer	xeer	
suuf	suuf	
		
suuf	suuf	
		
		
asamaan	asamaan	
		
		
		
		
		
		
		
yoon	yoon	
		
xonxa	xonxa	
werta	werta	
		
weex	weex	wɛːx
ñuul	ñuul	ɲuːl
guddi	guddi	
		
at	at	
		
sedda	sedda	
		
bees	bees	
magget	magget	
baax	baax	
		
		
tilim	tilim	
		
		
		
		
		
tooy	tooy	
wow	wow	
		
jege	jege	
sori	sori	
ndeyjoor	ndeyjoor	
cammooñ	cammooñ	
ci	ci	
ci biir	ci biir	
ak	ak	
ak	ak	
bu fekkee	bu fekkee	
ndaxte	ndaxte	
tur	tur	