أ	men	
ته	te	
وه	ve	
اِما	'ema	
شِما	Šemà	
وِشون	Vešun	
اینتا	Intà	
اونتا	'Untà	
اینجه	inje	
اونجه	'unje	
کی	ki	
چی	ci	
کاجه	kaje	
که	key	
چِتی	cheti	
	Ná	
دشت	dæšt	
خله	xale	
بعضیون	Baèziun	
پریک	Perik	
دِی	dey	
اتا	attä	
دِ	de	
سه	se	
بِر	Ber	
پِنج	Penj	
گَت	gat	
دراز	Deráz	
پَن	pan	
کالفت	kaleft	
سنگین	sangin	
پچوک	Pecuk	
کال	Kàl	
زِغ	Zeʁ	
نازک	nazek	
زنا	Zenà	
مردی	mardi	
آدمیزا	Àdmizà	
یال	Vace/yàl	
زنا	zena	
شی	ŠI	
مار	màr	
پییر	piyer	
سور	Sur	
شیم	Šim	
مِرغ	Merʁ	
سگ	sag	
اِسپیج	espij	
مَر	mar	
کرم	kerm	
دار	dar	
جِنگِل	jengel	
چماق	chomagh	
		
تیم	tim	
	gella	
ریشه	rishe	
گلام	gelam	
گل	gol	
بند	band-e-vash	
رَسِن	rasen	
جلد	jeld	
گوشت	gusht	
خون	khun	
هِسِّکا	hesseka	
راغون	raghun	
مرغانه	merghane	
		
دم	dem	
پر	par	
می	mi	
سَر	sar	
گوش	gush	
چـِش	chesh	
دِماغ	demagh	
داهون	dahun	
		
زوون	zevun	
		
چَک	chak	
لینگ	ling	
		
دَس	das/bal	
بال	bal	
اِشکِم	eshkem	
چنیک	chenik	
گِس	ges	
پِشت	pesht	
سینه	sine	
دل	del	
جیگر	jiger	
		
بَخاردِن	baxarden	
دَئیشتِن	da'ishten	
بَلِشتِن	baleshten	
تف	tof	
اخ	akh tof	
سَر	sar hakerden	
نفس	nafes bakshiyen	
ریک	rik	
هارشی‌ین	harshiyen	
بشناسِّن	beshnassen	
دونستن	dunesten	
فکر	fekr hakerden	
دَیِّن	dayyen	
بترسی‌ین	batersiyen	
بخاتن	bakhaten	
		
بمردن	bamerden	
بکاشتن	bakashten	
بجنگستن	bajengesten	
اشکار	eshkar hakerden	
بزوئن	bazuen	
بَوری‌ین	bavriyen	
		
		
		
بکندسن	bakendesen	
هولی	huli hakerden	
بپرستن	baperesten	
را	ra burden	
بموئن	bemuen	
له	le burden	
هنیشتن	henishten	
هرستائن	herestaen	
بگردستن	bagerdesen	
دکتن	daketen	
هدائن	hedaen	
نگه	negah dashtan	
		
		
بشستن	bashesten	
		
دَکشی‌ین	dakshiyen	
فشار	feshar hedaen	
کپّل	kappel hakerden	
		
بَدوتِن	baduten	
بشمارستن	beshmaresten	
بائوتن	bauten	
ریکن	riken	
کا	ka hakerden	
هرستائن	herestaen	
		
		
		
خورشید	khorshid	
ماه	mah	
اساره	esare	
ئو	o	
وارش	varesh	
روخنه	rokhene	roːxənɐ
دریامونا	deryamuna	
دریا	derya	
نمک	nemek	
سنگ	sang/kalum	
ماسه	mase	
		
بنه	bene	
میاه	miyah	
میاه	miyah	
آسمون	asemun	
وا	va	
ورف	varf	
یخ	yakh	
دی	di	
تش	tash	taʃ
کلین	kelin	
بسوتن	basuten	
را	ra	
سی	si	
سِرخ	serkh	
سبز	sabz	
زرد	zard	
اسپه	espe	əspeː
سیو	siyu	
شو	sho	
روز	ruj	
سال	sal	
گرم	garm	
سرد	sard	
پر	per	
نو	no	
قدیمی	ghadimi	
خار	khar	
بد	bad	
بپیسّه	bapisse	
لَچِر	lacher	
راست	rast	
گرد	gerd	
تِج	tej	
مس	mes-mesi	
ساف	saf	
تار	tar	
خاشک	khashk	
درست	derest	
نزیک	nazzik	
دیر	dir	
راست	rast	
چپ	chap	
دله	dele	
دله	dele	
جه	je	
	u	
اگه	age	
	çun ke	
نوم	num	