ӕз	æz	
ду	du	
е	e	e
мах	max	
сумах	sumax	
етӕ	etæ	
айӕ	ajæ	
е	e	e
ами	ami	
уоми	uomi	
ка	ka	
ци	ci	
кӕми	kæmi	
кӕд	kæd	
куд	kud	
нӕ	næ	
ӕгас	ægas	
берӕ	beræ	
цалдӕр	caldær	
гӕзӕмӕ	gæzæmæ	
ӕндӕр	ændær	
еу	ew	
дууӕ	duwæ	
ӕртӕ	ærtæ	
цуппaр	cuppar	
фондз	fonʒ	
устур	ustur	
даргъ	darǧ	
фӕтӕн	fætæn	
ставд	stavd	
уӕззау	wæzzaw	
минги	mingi	
цубур	cubur	
унгӕг	ungæg	
тӕнӕг	tænæg	
силгоймаг	silgojmag	
нӕлгоймаг	nælgojmag	
адӕймаг	adæjmag	ä́.d̪ɐj.mäk
сувӕллон	suvællon	
уосӕ	uosæ	
мойнӕ	mojnæ	
мадӕ	madæ	
фидӕ	fidæ	
цӕрӕгой	cærægoj	
кӕсалгӕ	kæsalgæ	
маргъ	marǧ	
куй	kuj	
систӕ	sistæ	
калм	kalm	
кӕлмӕ	kælmæ	
бӕласӕ	bælasæ	
гъӕдӕ	ǧædæ	
къуӕцӕл	k’wæcæl	
рӕзӕ	ræzæ	
		
сифӕ	sifæ	
бундзарӕ	bunʒaræ	
		
деден	deden	
кӕрдӕг	kærdæg	
рӕвӕйнӕ	rævæjnæ	
дзар	ʒar	
		
		
		
		
		
		
		
		
		
		
		
		
		
		
		
		
		
		
		
		
		
		
хъӕстӕ	qæstæ	
хӕлорӕ	xæloræ	
ӕвгӕрдӕн	ævgærdæn	
		
		
		
		
		
		
		
		
		
		
		
		
		
		
		
фӕсмӕрун	fæsmærun	
		
		
		
		
		
		
		
		
		
		
		
		
		
		
ӕзгелун	æzgelun	
накӕ кӕнун	nakæ kænun	
		
		
		
		
		
истун	istun	
		
		
		
		
		
		
		
		
		
		
гӕлдзун	gælʒun	
		
		
		
		
		
		
		
		
		
		
		
		
		
		
		
		
		
		
		
		
		
		
		
		
		
арв	arv	
		
		
		
хъуӕцӕ	qwæcæ	
		
		
цӕфсун	cæfsun	
над	nad	
		
		
		
		
		
		
		
		
		
		
		
		
		
		
		
		
		
цъумур	c’umur	
		
		
		
		
		
		
		
		
		
изол	izol	
		
		
		
		
ӕд	æd	
дӕр	dær	
ку	ku	
уомӕн ӕма	uomæn æma	
ном	nom	