k-	k-	
p-	p-	
s-	s-	
		
		
		
heʼ	heʼ	
loʼ	loʼ	
		
		
kuneʼ	kuneʼ	
sukʼu	sukʼu	
takaʼ	takaʼ	
		
		
ʼinsil	ʼinsil	
yilaʼ	yilaʼ	
ʼɨhɨ	ʼɨhɨ	
		
		
		
pakaš	pakaš	
ʼiškom̓	ʼiškom̓	
masɨx	masɨx	
skumu	skumu	
yitipakaš	yitipakaš	
		
		
		
		
xulxul	xulxul	
		
		
		
		
ʼeneq	ʼeneq	
ʼɨhɨy̓	ʼɨhɨy̓	
ku	ku	
chʼichʼiʼ	chʼichʼiʼ	
tal̓ik	tal̓ik	
is-hɨy̓	is-hɨy̓	
tɨkʼ	tɨkʼ	
kokoʼ	kokoʼ	
		
ʼal̓ilimuw	ʼal̓ilimuw	
wicʼ	wicʼ	
huchu	huchu	
šik	šik	
xshap	xshap	
		
pon̓	pon̓	
		
pon̓	pon̓	
		
ʼamɨn̓	ʼamɨn̓	
qap	qap	
		
		
pey̓	pey̓	
xweq	xweq	
skɨnɨtʼ	skɨnɨtʼ	
pax	pax	
amɨn̓	amɨn̓	
		
se	se	
s-xil	s-xil	
tumun	tumun	
		
teleqʼ	teleqʼ	
qap	qap	
šuš	šuš	
		
tuʼ	tuʼ	
tɨx	tɨx	
noxsh	noxsh	
ʼɨk	ʼɨk	
sa	sa	
ʼelew	ʼelew	
sixway̓	sixway̓	
tem̓	tem̓	
ʼɨl̓	ʼɨl̓	
ʼapam̓	ʼapam̓	
pu	pu	
		
		
		
niʼ	niʼ	
mɨt	mɨt	
kutet	kutet	
ʼayapis	ʼayapis	
ʼal̓	ʼal̓	
ʼaqmil	ʼaqmil	
ʼuw	ʼuw	
		
		
		
paš	paš	
ʼax ti-pak	ʼax ti-pak	
kalaš	kalaš	
		
kuti	kuti	
ʼitaq	ʼitaq	
		
aqniwil	aqniwil	
yuxsh	yuxsh	
		
weʼ	weʼ	
atɨk	atɨk	
aqšan	aqšan	
		
axi-č	axi-č	
		
		
iwawan	iwawan	
		
		
		
pul	pul	
aqiwɨwɨn	aqiwɨwɨn	
xonowon	xonowon	
nanan̓	nanan̓	
yɨti	yɨti	
sotoy̓in	sotoy̓in	
ɨlɨkʼɨn	ɨlɨkʼɨn	
kuta'	kuta'	
		
tol	tol	
		
ul̓ish	ul̓ish	
		
nim̓uy	nim̓uy	
uxmaniwon	uxmaniwon	
		
		
		
		
aqsik	aqsik	
		
		
ʼip	ʼip	
expech	expech	
		
		
		
		
		
qsi	qsi	
ʼaway̓	ʼaway̓	
ʼaqiwo	ʼaqiwo	
ʼoʼ	ʼoʼ	
tuhuy	tuhuy	
		
		
sxam̓in	sxam̓in	
tip	tip	
xɨp	xɨp	
		
		
šup	šup	
ʼiqcʼiʼ	ʼiqcʼiʼ	
smomoy	smomoy	
		
saxtakhɨt	saxtakhɨt	
		
		
tow̓	tow̓	
nɨ	nɨ	
ixša	ixša	
ixut	ixut	
chʼayash	chʼayash	
milimol	milimol	
tasɨn	tasɨn	
ʼaqulapshan	ʼaqulapshan	
		
ʼoʼwow	ʼoʼwow	
shoyin	shoyin	
saxiyiʼ	saxiyiʼ	
qsi	qsi	
		
ishaw	ishaw	
axcʼacʼax	axcʼacʼax	
		
ʼikɨmin	ʼikɨmin	
ʼequn	ʼequn	
chho-chhoho	chho-chhoho	
ʼaxɨmɨkʼ	ʼaxɨmɨkʼ	
		
nuyič	nuyič	
kɨyɨmi	kɨyɨmi	
		
cʼɨcʼɨ	cʼɨcʼɨ	
		
		
soʼoʼoč	soʼoʼoč	
aqawan	aqawan	
		
mutey̓	mutey̓	
mɨk	mɨk	
		
		
mi-	mi-	
mi-	mi-	
		
na	na	
		
		
tɨ	tɨ	