сэ		sa
о		wa
ар		aːr
тэ		ta
шъо		ʃʷa
ахэр		aːxar
мы		mə
мо		
мыщ		
ащ адэ		
хэт		xat
сыд		səd
тыдэ		təda
сыдигъо		sədəjʁʷa
сыдэущтэу		sədawɕtaw
мы		mə
зэкӀэ		
бэ		ba
заул		
макӀэу		
пэмыкӀ		
зы		zə
тӀу		tʷʼə
щы		ɕə
плӀы		pɬʼə
тфы		tfə
ины		jənə
кӀыхьэ		
шъуамбгъо		ʂʷaːmbʁʷaː
гъумы		ʁʷəmə
хьылъэ		ħəɬa
цӀыкӀу		
кӀако		
бгъузэ		bʁʷəza
псыгъо		psəʁʷa
бзылъфыгъ		
хъулъфыгъ		
цӀыфы		t͡sʼəfə
сабый		saːbəj
шъуз		ʂʷəzə
лӀы		ɬʼə
ны		nə
ты		tə
хьакӀэ-къуакӀ		
пцэжъый		
бзыу		bzəw
хьэ		ħa
цIэ		
блэ		bla
хьамлыу		ħamləw
чъыгы		t͡ɕəɣə
мэзы		mazə
бэщ		baɕ
пхъэшъхьэ-мышъхь		
кIэ		
тхьап		
лъапсэ		ɬaːpsa
пхъашъо		
къэгъагъ		
уцы		wət͡sə
кIапсэ		
кIышъу		
лы		ɮə
лъы		ɬə
къупшъхьэ		
шэ		ʃa
кIэнкIэ		
бжъэ		bʐa
кIэ		
къамзый		
цы		t͡sə
шъхьэ		ʂħa
тхьакIум		
нэ		na
пэ		pa
жэ		ʒa
цэ		t͡sa
бзэгу		bzaɡʷ
Iэбжъанэ		
лъэгу		ɬaɡʷ
лъакъо		ɬaːqʷa
лъэгуанджэ		ɬaɡʷaːnd͡ʒa
Iэ		
тамэ		taːma
ныбэ		nəba
кIэтIый		
пшъэ		pʂa
кIыб		
бгъэ		bʁa
гу		ɡʷə
тхьамшIыгъу		
ешъон		jaʂʷan
шхэн		ʃxan
ецэкъэн; егъун		
кIэшъун		
ужъунтхэн		wəʒʷəntxan
къепщэн		qajpɕan
жьы къэщэн		ʑə qaɕan
щхын		ɕxən
лъэгъун		pɬaʁʷən
зэхэхын		zaxaxən
шIэн		
егупшысэн		jaɡʷəpʃəsan
пэмэн		paman
щынэн		ɕənan
чъыен		t͡ʂəjan
псэун		psawən
лIэн		
укIын		
бэнэн		banan
		
еон		jawan
бзын		bzən
зэпыупкIын		
хэсэн		xasan
пIэстхъэн		
тIын		
есын		jasən
быбын		bəbən
		
къэкIон		
щылъын		
щысын		
щытын		ɕətən
гъэзэн		ʁazan
къефэхын		qajfaxən
етын		jatən
Iыгъын		
къузын		
гъэушыкъоин		
лъэсын		
лъэкIын		
лъэшъун		ɬaʃʷən
еIункIын		
дзын		d͡zən
пхын		pxən
дын		dən
лъытэн		ɬətan
къэIон		
орэд къэIон		
джэгун		d͡ʒaɡʷən
есын		jasən
чъэн		tʂan
щтын		ɕtən
бэгын		baɣən
тыгъэ		təʁa
мазэ		maːza
жъуагъо		ʒʷaːʁʷa
псы		psə
ощхы		waɕxə
псыхъу		
хыкъум		
хы		xə
щыгъу		ɕəʁʷ
мыжъо		məʐʷa
пшахъо		pʃaχʷa
сап		
чIы		
ошъуапщэ		waʂʷaːpɕa
пщагъу		pɕaːʁʷ
уашъо		waːʃʷa
жьыбгъэ		ʑəbʁa
осы		wasə
мылы		məɮə
Iугъо		
машIо		
яжьэ		jaːʑa
стын		stən
гъогу		ʁʷaɡʷ
къушъхьэ		qʷəʂħa
плъыжьы		pɬəʑə
уцышъо		wət͡səʂʷa
гъожьы		ʁʷaʑə
шхъуантIэ		
фыжьы		fəʑə
шIуцIэ		
чэщы		t͡ʃaɕə
мафэ		maːfa
гъэ		ʁa
фабэ		faːba
чъыIэ		
из		
кIэ		
жъы		ʐə
дэгъу		daʁʷə
дэи		dajə
шъугъэ		
шIой		
занкIэ		
хъурай		χʷəraːj
чан		t͡ʃaːn
цако		t͡saːkʷa
зэщиз		
цIынэ		
гъушъ		
тэрэз		taraz
благъэ		blaːʁa
чыжьэ		t͡ʃəʑa
джабгъу		
сэмэгу		samaɡʷ
дэжь		daʑ
		
		
ыкIи		
-мэ		
сыда пӀомэ		
цӀэ		t͡sʼa