eu	eu	ew
tu	tu	tu
ele	ele	ˈelɨ
nós	nós	nɔʃ
vós	vós	vɔʃ
eles	eles	ˈelɨʃ
isto	isto	ˈiʃtu
aquilo	aquilo	ɐˈkilu
aqui	aqui	ɐˈki
aí	aí	ɐˈi
quem	quem	kɐ̃j̃
que	que	kɨ
onde	onde	ˈõdɨ
quando	quando	ˈkwɐ̃du
como	como	ˈkomu
não	não	nɐ̃w̃
todo	todo	ˈtoðu
muito	muito	ˈmũj̃tu
alguns	alguns	aɫˈɣũʃ
pouco	pouco	ˈpo
outro	outro	ˈo
um	um	ũ
dois	dois	doiʃ
três	três	tɾeʃ
quatro	quatro	ˈkwatɾu
cinco	cinco	ˈsĩku
grande	grande	ˈɡɾɐ̃dɨ
longo	longo	ˈlõɡu
largo	largo	ˈlaɾɣu
espesso	espesso	ɨʃˈpesu
pesado	pesado	pɨˈzaðu
pequeno	pequeno	pɨˈkenu
curto	curto	ˈkuɾtu
estreito	estreito	ɨʃˈtɾɐjtu
fino	fino	ˈfinu
mulher	mulher	muˈʎɛɾ
homem	homem	ˈɔmɐ̃j̃
homem	homem	ˈɔmɐ̃j̃
criança	criança	kɾiˈɐ̃sɐ
mulher	mulher	muˈʎɛɾ
marido	marido	mɐˈɾiðu
mãe	mãe	mɐ̃j̃
pai	pai	pai
animal	animal	ɐniˈmaɫ
peixe	peixe	ˈpɐjʃɨ
ave	ave	ˈavɨ
cão	cão	kɐ̃w̃
piolho	piolho	piˈoʎu
serpente	serpente	sɨɾˈpẽtɨ
verme	verme	ˈvɛɾmɨ
árvore	árvore	ˈaɾvuɾɨ
floresta	floresta	fluˈɾɛʃtɐ
bastão	bastão	bɐʃˈtɐ̃w̃
fruta	fruta	ˈfɾutɐ
semente	semente	sɨˈmẽtɨ
folha	folha	ˈfoʎɐ
raiz	raiz	ʁɐˈiʃ
casca	casca	ˈkaʃkɐ
flor	flor	floɾ
erva	erva	ˈɛɾvɐ
corda	corda	ˈkɔɾðɐ
pele	pele	ˈpɛlɨ
carne	carne	ˈkaɾnɨ
sangue	sangue	ˈsɐ̃ɡɨ
osso	osso	ˈosu
gordura	gordura	ɡuɾˈðuɾɐ
ovo	ovo	ˈovu
chifre	chifre	ˈʃifɾɨ
cauda	cauda	ˈkawðɐ
pena	pena	ˈpenɐ
cabelo	cabelo	kɐˈβelu
cabeça	cabeça	kɐˈβesɐ
orelha	orelha	oˈɾɐjʎɐ
olho	olho	ˈoʎu
nariz	nariz	nɐˈɾiʃ
boca	boca	ˈbokɐ
dente	dente	ˈdẽtɨ
língua	língua	ˈlĩɡwɐ
unha	unha	ˈuɲɐ
pé	pé	pɛ
perna	perna	ˈpɛɾnɐ
joelho	joelho	ʒuˈɐʎu
mão	mão	mɐ̃w̃
asa	asa	ˈazɐ
ventre	ventre	ˈvẽtɾɨ
entranhas	entranhas	ẽˈtɾɐɲɐʃ
pescoço	pescoço	pɨʃˈkosu
costas	costas	ˈkɔʃtɐʃ
peito	peito	ˈpɐjtu
coração	coração	kuɾɐˈsɐ̃w̃
fígado	fígado	ˈfiɣɐðu
beber	beber	bɨˈβeɾ
comer	comer	kuˈmeɾ
morder	morder	muɾˈdeɾ
sugar	sugar	suˈɡaɾ
cuspir	cuspir	kuʃˈpiɾ
vomitar	vomitar	vumiˈtaɾ
soprar	soprar	suˈpɾaɾ
respirar	respirar	ʁɨʃpiˈɾaɾ
rir	rir	ʁiɾ
ver	ver	veɾ
ouvir	ouvir	o
saber	saber	sɐˈbeɾ
pensar	pensar	pẽˈsaɾ
cheirar	cheirar	ʃɐjˈɾaɾ
temer	temer	tɨˈmeɾ
dormir	dormir	duɾˈmiɾ
viver	viver	viˈveɾ
morrer	morrer	muˈʁeɾ
matar	matar	mɐˈtaɾ
lutar	lutar	luˈtaɾ
caçar	caçar	kɐˈsaɾ
bater	bater	bɐˈteɾ
cortar	cortar	kuɾˈtaɾ
rachar	rachar	ʁɐˈʃaɾ
esfaquear	esfaquear	iʃfɐˈkjaɾ
raspar	raspar	ʁɐʃˈpaɾ
cavar	cavar	kɐˈvaɾ
nadar	nadar	nɐˈðaɾ
voar	voar	vuˈaɾ
andar	andar	ɐ̃ˈdaɾ
vir	vir	viɾ
deitar-se	deitar-se	dɐjˈtaɾse
sentar-se	sentar-se	sẽˈtaɾse
pôr-se de pé	pôr-se de pé	poɾse
virar	virar	viˈɾaɾ
cair	cair	kɐˈiɾ
dar	dar	daɾ
segurar	segurar	sɨɡuˈɾaɾ
apertar	apertar	ɐpɨɾˈtaɾ
esfregar	esfregar	ɨʃfɾɨˈɡaɾ
lavar	lavar	lɐˈvaɾ
enxugar	enxugar	ẽʃuˈɡaɾ
puxar	puxar	puˈʃaɾ
empurrar	empurrar	ẽpuˈʁaɾ
atirar	atirar	ɐtiˈɾaɾ
atar	atar	ɐˈtaɾ
coser	coser	kuˈzeɾ
contar	contar	kõˈtaɾ
dizer	dizer	diˈzeɾ
cantar	cantar	kɐ̃ˈtaɾ
brincar	brincar	bɾĩˈkaɾ
flutuar	flutuar	flutuˈaɾ
fluir	fluir	fluˈiɾ
gelar	gelar	ʒɨˈlaɾ
inchar	inchar	ĩˈʃaɾ
sol	sol	sɔl
lua	lua	ˈluɐ
estrela	estrela	ɨʃˈtɾelɐ
água	água	ˈaɡwɐ
chuva	chuva	ˈʃuvɐ
rio	rio	ˈʁiu
lago	lago	ˈlaɡu
mar	mar	maɾ
sal	sal	sal
pedra	pedra	ˈpɛdɾɐ
areia	areia	ɐˈɾɐjɐ
poeira	poeira	puˈɐjɾɐ
terra	terra	ˈtɛʁɐ
nuvem	nuvem	ˈnuvɐ̃j
nevoeiro	nevoeiro	nɨvuˈɐjɾu
céu	céu	sɛw
vento	vento	ˈvẽtu
neve	neve	ˈnɛvɨ
gelo	gelo	ˈʒelu
fumo	fumo	ˈfumu
fogo	fogo	ˈfoɡu
cinzas	cinzas	ˈsĩzɐʃ
arder	arder	ɐɾˈdeɾ
estrada	estrada	ɨʃˈtɾadɐ
montanha	montanha	mõˈtɐɲɐ
vermelho	vermelho	vɨɾˈmɐjʎu
verde	verde	ˈveɾdɨ
amarelo	amarelo	ɐmɐˈɾɛlu
branco	branco	ˈbɾɐ̃ku
preto	preto	ˈpɾetu
noite	noite	ˈnɔjtɨ
dia	dia	ˈdiɐ
ano	ano	ˈɐnu
quente	quente	kẽˈtɨ
frio	frio	ˈfɾiu
cheio	cheio	ˈʃɐju
novo	novo	ˈnovu
velho	velho	ˈvɛʎu
bom	bom	bõ
mau	mau	maw
podre	podre	ˈpodɾɨ
sujo	sujo	ˈsuʒu
direto	direto	diˈɾetu
redondo	redondo	ʁɨˈdõdu
afiado	afiado	ɐfiˈadu
cego	cego	ˈsɛɣu
liso	liso	ˈlizu
úmido	úmido	ˈumiðu
seco	seco	ˈseku
correcto	correcto	kuˈʁɛktu
perto	perto	ˈpɛɾtu
longe	longe	ˈlõʒɨ
direita	direita	di'rɐjtɐ
esquerda	esquerda	ɨʃˈkeɾðɐ
a	a	ɐ
em	em	ɐ̃j̃
com	com	kõ
e	e	i
se	se	sɨ
porque	porque	ˈpuɾkɨ
nome	nome	ˈnomɨ