eu	eu	jew
tu	tu	tu
el	el	jel
noi	noi	noj
voi	voi	voj
ei	ei	ˈjej
acesta	acesta	aˈt͡ʃes.ta
acela	acela	aˈt͡ʃe.la
aici	aici	aˈit͡ʃʲ
acolo	acolo	aˈko.lo
cine 	cine 	ˈt͡ʃi.ne
ce 	ce 	t͡ʃe
unde 	unde 	ˈun.de
când 	când 	kɨnd
cum 	cum 	ˈkum
nu	nu	nu
tot	tot	tot
mulți	mulți	mult͡sʲ
niște	niște	ˈniʃ.te
puțin	puțin	puˈt͡sin
alt	alt	alt
unu	unu	ˈu.nu
doi	doi	doj
trei	trei	ˈtrej
patru	patru	ˈpa.tru
cinci	cinci	t͡ʃint͡ʃʲ
mare	mare	ˈma.re
lung	lung	luŋɡ
larg	larg	larɡ
gros	gros	ɡros
greu	greu	ɡrew
mic	mic	mik
scurt	scurt	skurt
strâmt	strâmt	strɨmt
subțire	subțire	subˈt͡si.re
femeie	femeie	fe.ˈme.je
bărbat	bărbat	bərˈbat
om	om	om
copil	copil	koˈpil
soție	soție	soˈt͡sije
soț	soț	sot͡s
mamă	mamă	ˈma.mə
tată	tată	ˈta.tə
animal	animal	a.niˈmal
pește	pește	ˈpeʃ.te
pasăre	pasăre	
câine	câine	ˈkɨj.ne
păduche	păduche	
șarpe	șarpe	ˈʃarpe
vierme	vierme	
arbore	arbore	ˈaɾ.bo.re
pădure	pădure	pəˈdu.re
băț	băț	
fruct	fruct	
sămânță	sămânță	səˈmɨntsə
frunză	frunză	ˈfrun.zə
rădăcină	rădăcină	
scoarță	scoarță	ˈsko̯ar.t͡sə
floare	floare	ˈflo̯a.re
iarbă	iarbă	ˈjar.bə
sfoară	sfoară	
piele	piele	ˈpjele
carne	carne	ˈkarne
sânge	sânge	ˈsɨn.d͡ʒe
os	os	os
grăsime	grăsime	
ou	ou	ow
corn	corn	korn
coadă	coadă	ˈko̯adə
pană	pană	
păr	păr	pər
cap	cap	ˈkap
ureche	ureche	uˈre.ke
ochi	ochi	okʲ
nas	nas	ˈnas
gură	gură	ˈɡu.rə
dinte	dinte	ˈdinte
limbă	limbă	ˈlim.bə
unghie	unghie	ˈuŋ.ɡje
picior	picior	piˈt͡ʃor
picior	picior	piˈt͡ʃor
genunchi	genunchi	dʒeˈnunkʲ
mână	mână	ˈmɨ.nə
aripă	aripă	aˈri.pə
burtă	burtă	ˈbur.tə
măruntaie	măruntaie	
gât	gât	ɡɨt
spate	spate	ˈspate
piept	piept	pjept
inimă	inimă	ˈinimə
ficat	ficat	
bea	bea	be̯a
mânca	mânca	mɨnˈka
mușca	mușca	muʃˈka
suge	suge	ˈsu.d͡ʒe
scuipa	scuipa	
borî	borî	boˈrɨ
sufla	sufla	suˈfla
răsufla	răsufla	
râde	râde	ˈrɨ.de
vedea	vedea	veˈde̯a
auzi	auzi	
ști	ști	ˈʃti
cugeta	cugeta	ku.d͡ʒeˈta
mirosi	mirosi	mi.roˈsi
teme	teme	ˈte.me
dormi	dormi	dorˈmi
trăi	trăi	trəˈi
muri	muri	muˈri
ucide	ucide	uˈtʃi.de
lupta	lupta	
vâna	vâna	
lovi	lovi	
tăia	tăia	
despica	despica	
înjunghia	înjunghia	
zgâria	zgâria	
săpa	săpa	
înota	înota	
zbura	zbura	zbuˈra
merge	merge	ˈmer.d͡ʒe
veni	veni	veˈni
zăcea	zăcea	zəˈtʃe̯a
așeza	așeza	a.ʃeˈza
scula	scula	skuˈla
întoarce	întoarce	ɨn.ˈto̯ar.t͡ʃe
cădea	cădea	kəˈde̯a
da	da	da
ținea	ținea	
strânge	strânge	
freca	freca	freˈka
spăla	spăla	spəˈla
șterge	șterge	
trage	trage	ˈtra.d͡ʒe
împinge	împinge	ɨmˈpin.d͡ʒe
arunca	arunca	
lega	lega	
coase	coase	ˈko̯a.se
număra	număra	nu.mə.ˈra
zice	zice	ˈzi.t͡ʃe
cânta	cânta	kɨnˈta
juca	juca	ʒu.ˈka
pluti	pluti	pluˈti
curge	curge	
îngheța	îngheța	
umfla	umfla	umˈfla
soare	soare	ˈso̯a.re
lună	lună	ˈlu.nə
stea	stea	ste̯a
apă	apă	ˈa.pə
ploaie	ploaie	ˈplo̯a.je
râu	râu	ˈrɨw
lac	lac	
mare	mare	ˈma.re
sare	sare	ˈsa.re
piatră	piatră	ˈpja.trə
nisip	nisip	niˈsip
praf	praf	praf
pământ	pământ	pəˈmɨnt
nor	nor	nor
ceață	ceață	ˈt͡ʃe̯a.t͡sə
cer	cer	t͡ʃer
vânt	vânt	
zăpadă	zăpadă	zəˈpadə
gheață	gheață	
fum	fum	
foc	foc	fok
cenușă	cenușă	
arde	arde	ˈar.de
drum	drum	ˈdrum
munte	munte	ˈmun.te
roșu	roșu	ˈro.ʃu
verde	verde	ˈver.de
galben	galben	ˈɡal.ben
alb	alb	alb
negru	negru	ˈne.ɡru
noapte	noapte	ˈno̯ap.te
zi	zi	ˈzi
an	an	an
cald	cald	kald
rece	rece	ˈret͡ʃe
plin	plin	plin
nou	nou	now
vechi	vechi	vekʲ
bun	bun	bun
rău	rău	rəw
putred	putred	ˈpu.tred
murdar	murdar	mur.ˈdar
drept	drept	drept
rotund	rotund	roˈtund
ascuțit	ascuțit	as.kuˈt͡sit
tocit	tocit	toˈt͡ʃit
neted	neted	ˈne.ted
ud	ud	ud
uscat	uscat	usˈkat
drept	drept	drept
lângă	lângă	ˈlɨn.ɡə
departe	departe	deˈpar.te
drept	drept	drept
stâng	stâng	stɨŋɡ
la	la	la
în	în	ɨn
cu	cu	ku
și	și	ʃi
dacă	dacă	ˈda.kə
deoarece	deoarece	de.o̯a.reˈt͡ʃe
nume	nume	ˈnu.me