yo	yo	
tu	tu	
		
nos	nos	
vos	vos	
		
esto	esto	
qui	qui	ˈki
aqui	aqui	
y	y	
quen	quen	
que	que	
u	u	
quando	quando	
como	como	
non	non	
todo	todo	
muito	muito	
algũus	algũus	
pouco	pouco	
outro	outro	
un	un	
dous	dous	
tres	tres	ˈtɾes
quatro	quatro	ˈkwatɾo
cinco	cinco	
grande	grande	
longo	longo	
ancho	ancho	
grosso	grosso	
pesado	pesado	
pequeno	pequeno	
curto	curto	
estreito	estreito	
magro	magro	
moller	moller	
ome	ome	
ome	ome	
infante	infante	
moller	moller	
marido	marido	maˈɾido
madre	madre	
padre	padre	ˈpadɾe
besta	besta	
peixe	peixe	
ave	ave	
can	can	
peollo	peollo	
coobra	coobra	
vermen	vermen	
arvor	arvor	
furesta	furesta	
baston	baston	
fruita	fruita	
semente	semente	
folla	folla	
raiz	raiz	
cortiça	cortiça	
fror	fror	
erva	erva	
corda	corda	
pele	pele	
carne	carne	ˈkaɾne
sangui	sangui	
osso	osso	ˈoso
gordura	gordura	
ovo	ovo	
corno	corno	
rabo	rabo	
pena	pena	
cabelo	cabelo	
cabeça	cabeça	kaˈbet͡sa
orella	orella	
ollo	ollo	
nariz	nariz	
boca	boca	ˈboka
dente	dente	
lingua	lingua	
unna	unna	
pee	pee	
perna	perna	
gẽollo	gẽollo	
mão	mão	
aa	aa	
ventre	ventre	
tripas	tripas	
colo	colo	
costas	costas	
peito	peito	
coraçon	coraçon	koɾaˈt͡son
figado	figado	ˈhiɡado
bever	bever	
comer	comer	koˈmeɾ
morder	morder	
mamar	mamar	
cospir	cospir	
		
soprar	soprar	
		
riir	riir	
veer	veer	
ouvir	ouvir	
saber	saber	
pensar	pensar	
cheirar	cheirar	
temer	temer	
dormir	dormir	
viver	viver	
morrer	morrer	
matar	matar	
pelejar	pelejar	
caçar	caçar	
bater	bater	
cortar	cortar	
		
acuitelar	acuitelar	
rascar	rascar	
cavar	cavar	
nadar	nadar	
voar	voar	
andar	andar	
vĩir	vĩir	
jazer	jazer	
sentar	sentar	
levantar	levantar	
		
caer	caer	
dar	dar	
tẽer	tẽer	
apertar	apertar	
		
lavar	lavar	
terger	terger	
puxar	puxar	
empuxar	empuxar	
lançar	lançar	
atar	atar	
coser	coser	
contar	contar	
contar	contar	
cantar	cantar	
jogar	jogar	
boiar	boiar	
correr	correr	
gelar	gelar	
inchar	inchar	
sol	sol	
lũa	lũa	
estrela	estrela	
agua	agua	ˈaɡwa
chuvia	chuvia	
rio	rio	
lago	lago	
mar	mar	
sal	sal	ˈsal
pedra	pedra	
arẽa	arẽa	
poo	poo	
terra	terra	
nuve	nuve	
nevoeiro	nevoeiro	
ceo	ceo	
vento	vento	
neve	neve	
geo	geo	
fumo	fumo	ˈhumo
fogo	fogo	
cĩisa	cĩisa	
queimar	queimar	
caminno	caminno	
montanna	montanna	monˈtaɲa
vermello	vermello	
verde	verde	ˈβeɾde
amarelo	amarelo	
branco	branco	
negro	negro	
noite	noite	
dia	dia	ˈdia
ano	ano	
caente	caente	
frio	frio	
chẽo	chẽo	
novo	novo	
vello	vello	
bon	bon	
mal	mal	
podre	podre	
lixoso	lixoso	
estreito	estreito	
redondo	redondo	
amoado	amoado	
romo	romo	
chão	chão	
mollado	mollado	
seco	seco	
reito	reito	
preto	preto	
longe	longe	
dereita	dereita	
sẽestra	sẽestra	
a	a	
en	en	
con	con	kon
e	e	e
se	se	s̺e
porque	porque	poɾˈke
nome	nome	ˈnɔme