iya'	iya'	
iko	iko	
aléna	aléna	
ta'	ta'	
mu	mu	
na	na	
iyaé	iyaé	
iyaro	iyaro	
konnyé	konnyé	
kutu	kutu	
niga	niga	
aga	aga	
téga	téga	
uppanna	uppanna	
maraga	maraga	
tennia	tennia	
iyamaneng	iyamaneng	
maéga	maéga	
		
siaré'	siaré'	
laing	laing	
séddi	séddi	
dua	dua	
tellu	tellu	
eppa	eppa	
lima	lima	
battoa	battoa	
lampé	lampé	
malebba'	malebba'	
maumpe'	maumpe'	
tane'	tane'	
biccu'	biccu'	
padde'	padde'	
cikke'	cikke'	
nipi	nipi	
makkunrai	makkunrai	
burané	burané	
tau	tau	
ana'	ana'	
béné	béné	
burané	burané	
indo'	indo'	
ambo'	ambo'	
olokolo'	olokolo'	
balé	balé	
manu'-manu'	manu'-manu'	
asu	asu	
lissa	lissa	
ulā	ulā	
ule'	ule'	
pong	pong	
ale'	ale'	
tekkeng	tekkeng	
bua	bua	
biné	biné	
daung	daung	
ure'	ure'	
		
ungă	ungă	
serī	serī	
tulū	tulū	
oli	oli	
juku	juku	
rara	rara	
buku	buku	
lunra'	lunra'	
tello'	tello'	
salo	salo	
ikko'	ikko'	
bulu	bulu	
gemme'	gemme'	
ulu	ulu	
culing	culing	
mata	mata	
inge'	inge'	
timu	timu	
isi	isi	
lila	lila	
kanuku	kanuku	
ajé	ajé	
		
uttu	uttu	
jari	jari	
panni	panni	
bebbua	bebbua	
peru	peru	
ellong	ellong	ˈəlːoŋ
alekke'	alekke'	
dada	dada	
jantung	jantung	
até	até	
énung	énung	
anré	anré	
ikking	ikking	
iso	iso	
méccu	méccu	
tallua	tallua	
seppung	seppung	
nappase'	nappase'	
cawa	cawa	
ita	ita	
éngkalinga	éngkalinga	
isseng	isseng	
pikkiri'	pikkiri'	
émmau	émmau	
tau	tau	
tinro	tinro	
tuo	tuo	
maté	maté	
uno	uno	
laga	laga	
rengngeng	rengngeng	
unru	unru	
polo	polo	
pué'	pué'	
gajang	gajang	
karebbé	karebbé	
kai	kai	
nangé	nangé	
luttu	luttu	
jokka	jokka	
engka	engka	
léwu	léwu	
tudang	tudang	
tettong	tettong	
balé'	balé'	
bueng	bueng	
beré	beré	
attenning	attenning	
jemmu	jemmu	
sappula'	sappula'	
bissa	bissa	
lullu'	lullu'	
rui	rui	
sorong	sorong	
genrang	genrang	
sio	sio	
jai	jai	
bilang	bilang	
pau	pau	
élong	élong	
culé	culé	
awang	awang	
massolo'	massolo'	
mattedde'	mattedde'	
wesso	wesso	
mata esso	mata esso	
kéteng	kéteng	
wittoéng	wittoéng	
wae	wae	
bosi	bosi	
salo	salo	
tappareng	tappareng	
tasi'	tasi'	
pejjé	pejjé	
batu	batu	
kessi'	kessi'	
awu	awu	
tana	tana	
ellung	ellung	
apung	apung	
langi	langi	
anging	anging	
mpunga ése'	mpunga ése'	
ése'	ése'	
rumpu	rumpu	
api	api	
awu	awu	
tunu	tunu	
tattana	tattana	
bulu	bulu	
cella'	cella'	
kudara'	kudara'	
maridi	maridi	
puté	puté	
bolong	bolong	
wenni	wenni	
esso	esso	ˈəsːo
taung	taung	
pella	pella	
keccé'	keccé'	
penno	penno	
baru	baru	
cua	cua	
pace'	pace'	
konja'	konja'	
kebbong	kebbong	
carépa	carépa	
lempu	lempu	
lébu	lébu	
madire'	madire'	
kunru	kunru	
lengngi	lengngi	
rica'	rica'	
rakko	rakko	
tuju	tuju	
seddé	seddé	
mabéla	mabéla	
atau	atau	
abio	abio	
ku	ku	
ilaleng	ilaleng	
sibawa	sibawa	
na	na	
iyaku	iyaku	
nasaba'	nasaba'	
aseng	aseng	ˈasəŋ