au	au	
o	o	
e	e	
keirau	keirau	
		
		
qō	qō	
qori	qori	
kē	kē	
keri	keri	
cei	cei	
cava	cava	
vei	vei	
ni	ni	
vakacava	vakacava	
sega ni	sega ni	
kece	kece	
		
		
		
		
dua	dua	ⁿdu.a
rua	rua	
tolu	tolu	
vā	vā	
lima	lima	
levu	levu	
balavu	balavu	
rāraba	rāraba	
vāvaku	vāvaku	
bībī	bībī	
lailai	lailai	
lekaleka	lekaleka	
rabalailai	rabalailai	
lila	lila	
yalewa	yalewa	
tagane	tagane	
tamata	tamata	
gone	gone	
wati-	wati-	
wati-	wati-	
tina-	tina-	
tama-	tama-	
manumanu	manumanu	
ika	ika	
manumanu	manumanu	
kolī	kolī	
kutu	kutu	
gata	gata	
baca ni qele	baca ni qele	
kau	kau	
veikau	veikau	
kau	kau	
vua-	vua-	
sore-	sore-	
drau-	drau-	
waka-	waka-	
kuli-	kuli-	
sē-	sē-	
cō	cō	
wa	wa	
kuli-	kuli-	
lewe ni manumanu	lewe ni manumanu	
drā	drā	
sui	sui	
uro	uro	
yaloka	yaloka	
leu	leu	
bui-	bui-	
vuti-	vuti-	
drauniulu	drauniulu	
ulu-	ulu-	
daliga-	daliga-	
mata-	mata-	
ucu-	ucu-	
gusu-	gusu-	
bati-	bati-	
yame-	yame-	
taukuku	taukuku	
yava-	yava-	
yava-	yava-	
duru-	duru-	
liga-	liga-	
taba-	taba-	
kete-	kete-	
kete-	kete-	
domo-	domo-	
daku-	daku-	
sucu-	sucu-	
uto-	uto-	
yate-	yate-	
gunu-va	gunu-va	
kana	kana	
kata	kata	
domi-ca	domi-ca	
kasivi-ta	kasivi-ta	
lua-raka	lua-raka	
uvu-ca	uvu-ca	
cegu-va	cegu-va	
dredre-vaka	dredre-vaka	
rai-ca	rai-ca	
rogo-ca	rogo-ca	
kilā	kilā	
nanuma	nanuma	
boi-ca	boi-ca	
rere-vaka	rere-vaka	
moce	moce	
bula-taka	bula-taka	
mate	mate	
vakamatea	vakamatea	
veivala-taka	veivala-taka	
vakasa	vakasa	
moku-ta	moku-ta	
musu-ka	musu-ka	
kavoro-taka	kavoro-taka	
coka-ta	coka-ta	
mila	mila	
keli-a	keli-a	
qalo-va	qalo-va	
vuka	vuka	
taubale	taubale	
lako mai	lako mai	
davo	davo	
dabe	dabe	
tū	tū	
gole	gole	
lutu-ma	lutu-ma	
soli-a	soli-a	
taura	taura	
loba-ka	loba-ka	
masi	masi	
sava-ta	sava-ta	
qusi	qusi	
drē	drē	
bili-ga	bili-ga	
viri-taka	viri-taka	
wiri-ca	wiri-ca	
culā	culā	
wiliwili	wiliwili	
kaya	kaya	
laga-ta	laga-ta	
qito-ra	qito-ra	
ciri-taka	ciri-taka	
drodro-laka	drodro-laka	
ceva-ta	ceva-ta	
vuce-laka	vuce-laka	
siga	siga	
vula	vula	
kalokalo	kalokalo	
wai	wai	
uca	uca	
uciwai	uciwai	
drano	drano	
waitui	waitui	
māsima	māsima	
vatu	vatu	
nuku	nuku	
kuvu	kuvu	
qele	qele	
ō	ō	
kabu	kabu	
lomalāgi	lomalāgi	
cagi	cagi	ðaŋi
uca cevata	uca cevata	
aisi	aisi	
kubou	kubou	
kama	kama	
dravusa	dravusa	
kama	kama	
gaunisala	gaunisala	
ulunivanua	ulunivanua	
damudamu	damudamu	
drokadroka	drokadroka	
dromodromo	dromodromo	
vulavula	vulavula	
loaloa	loaloa	
bogi	bogi	
siga	siga	
yabaki	yabaki	
katakata toka	katakata toka	
liliwa	liliwa	
sīnai	sīnai	
vou	vou	
qase	qase	
vinaka	vinaka	βi.na.ka
cā	cā	
vuca	vuca	
duka	duka	
dodonu	dodonu	
moqimoqili	moqimoqili	
gata	gata	
dreli	dreli	
dravia	dravia	
suasua	suasua	
māmaca	māmaca	
donu	donu	
vōleka	vōleka	
yawa	yawa	
imatau	imatau	
imawī	imawī	
e	e	
e	e	
kei	kei	
ia	ia	
kē	kē	
baleta	baleta	
yaca-	yaca-	