ako	ako	ʔaˈko
ikaw	ikaw	ʔiˈkaw
siya	siya	siˈa
tayo	tayo	ˈtajo
kayo	kayo	kaˈjo
sila	sila	siˈla
ito	ito	ʔiˈto
iyan	iyan	ʔiˈan
dito	dito	ˈdito
doon	doon	doˈʔon
sino	sino	ˈsino
ano	ano	ʔaˈno
saan	saan	saˈʔan
kailan	kailan	kaʔiˈlan
paano	paano	paˈʔano
hindi	hindi	hinˈdiʔ
lahat	lahat	laˈhat
marami	marami	maˈɾami
ilan	ilan	ʔiˈlan
kaunti	kaunti	kaʔunˈtiʔ
iba	iba	ʔiˈba
isa	isa	ʔiˈsa
dalawa	dalawa	dalaˈwa
tatlo	tatlo	tatˈlo
apat	apat	ˈʔapat
lima	lima	liˈma
malaki	malaki	malaˈki
mahaba	mahaba	maˈhabaʔ
malapad	malapad	maˈlapad
makapal	makapal	makaˈpal
mabigat	mabigat	mabiˈɡat
maliit	maliit	maliˈʔit
maliit	maliit	maliˈʔit
makitid	makitid	maˈkitid
manipis	manipis	maniˈpis
babae	babae	baˈbaʔe
lalaki	lalaki	laˈlaki
tao	tao	ˈtaʔo
bata	bata	ˈbataʔ
asawa	asawa	ʔaˈsawa
asawa	asawa	ʔaˈsawa
ina	ina	ʔiˈna
ama	ama	ʔaˈma
hayop	hayop	ˈhajop
isda	isda	ʔisˈdaʔ
ibon	ibon	ˈʔibon
aso	aso	ˈʔaso
kuto	kuto	ˈkuto
ahas	ahas	ˈʔahas
uod	uod	ˈʔuʔod
punungkahoy	punungkahoy	
kakahuyan	kakahuyan	kakahuˈjan
patpat	patpat	
bunga	bunga	ˈbuŋa
binhi	binhi	binˈhiʔ
dahon	dahon	ˈdahon
ugat	ugat	ʔuˈɡat
balat ng puno	balat ng puno	
bulaklak	bulaklak	bulakˈlak
damo	damo	daˈmo
tali	tali	ˈtaliʔ
balat	balat	baˈlat
karne	karne	kaɾˈne
dugo	dugo	duˈɡoʔ
buto	buto	buˈto
taba	taba	taˈbaʔ
itlog	itlog	ʔitˈloɡ
sungay	sungay	ˈsuŋaj
buntot	buntot	bunˈtot
balahibo	balahibo	balaˈhibo
buhok	buhok	buˈhok
ulo	ulo	ˈʔulo
tenga	tenga	ˈteŋa
mata	mata	maˈta
ilong	ilong	ʔiˈloŋ
bunganga	bunganga	buˈŋaŋaʔ
ngipin	ngipin	ˈŋipin
dila	dila	ˈdilaʔ
kuko	kuko	kuˈko
paa	paa	paˈʔa
binti	binti	binˈtiʔ
tuhod	tuhod	ˈtuhod
kamay	kamay	kaˈmaj
pakpak	pakpak	pakˈpak
tiyan	tiyan	tiˈan
bituka	bituka	biˈtuka
leeg	leeg	leˈʔeɡ
likod	likod	liˈkod
suso	suso	ˈsuso
puso	puso	ˈpusoʔ
atay	atay	ʔaˈtaj
inom	inom	ʔiˈnom
kain	kain	ˈkaʔin
kagat	kagat	kaˈɡat
sipsip	sipsip	sipˈsip
luwa	luwa	luˈaʔ
suka	suka	ˈsuka
ihip	ihip	ˈʔihip
hinga	hinga	hiˈŋa
tawa	tawa	ˈtawa
tingin	tingin	tiˈŋin
dinig	dinig	diˈniɡ
alam	alam	ʔaˈlam
isip	isip	ˈʔisip
amoy	amoy	ʔaˈmoj
takot	takot	taˈkot
tulog	tulog	ˈtuloɡ
buhay	buhay	ˈbuhaj
patay	patay	paˈtaj
patay	patay	paˈtaj
laban	laban	ˈlaban
mangaso	mangaso	maˈŋaso
tama	tama	ˈtamaʔ
putol	putol	ˈputol
biyak	biyak	biˈak
saksak	saksak	sakˈsak
kamot	kamot	ˈkamot
hukay	hukay	ˈhukaj
langoy	langoy	laˈŋoj
lipad	lipad	liˈpad
lakad	lakad	ˈlakad
dating	dating	daˈtiŋ
higa	higa	hiˈɡaʔ
upo	upo	ˈʔupo
tayo	tayo	ˈtajo
liko	liko	liˈkoʔ
hulog	hulog	ˈhuloɡ
bigay	bigay	biˈɡaj
hawak	hawak	ˈhawak
pisil	pisil	piˈsil
kuskos	kuskos	kusˈkos
hugas	hugas	ˈhuɡas
punas	punas	
hila	hila	ˈhila
tulak	tulak	ˈtulak
tapon	tapon	taˈpon
tali	tali	ˈtaliʔ
tahi	tahi	taˈhiʔ
bilang	bilang	ˈbilaŋ
sabi	sabi	ˈsabi
awit	awit	ˈʔawit
laro	laro	laˈɾoʔ
lutang	lutang	ˈlutaŋ
agos	agos	ˈʔaɡos
tigas	tigas	tiˈɡas
maga	maga	
araw	araw	ˈʔaɾaw
buwan	buwan	buˈan
bituin	bituin	bituˈʔin
tubig	tubig	ˈtubiɡ
ulan	ulan	ʔuˈlan
ilog	ilog	ˈʔiloɡ
lawa	lawa	ˈlawaʔ
dagat	dagat	ˈdaɡat
asin	asin	ʔaˈsin
bato	bato	baˈto
buhangin	buhangin	buˈhaŋin
alikabok	alikabok	ʔalikaˈbok
lupa	lupa	ˈlupaʔ
alapaap	alapaap	ʔalaˈpaʔap
hamog	hamog	haˈmoɡ
langit	langit	ˈlaŋit
hangin	hangin	ˈhaŋin
niyebe	niyebe	niˈebe
yelo	yelo	ˈjelo
usok	usok	ˈʔusok
apoy	apoy	ʔaˈpoj
abo	abo	ʔaˈbo
sunogin	sunogin	
daan	daan	daˈʔan
bundok	bundok	bunˈdok
pula	pula	puˈla
berde	berde	ˈbeɾde
dilaw	dilaw	diˈlaw
puti	puti	puˈtiʔ
itim	itim	ʔiˈtim
gabi	gabi	ɡaˈbi
araw	araw	ˈʔaɾaw
taon	taon	taˈʔon
mainit	mainit	maˈʔinit
malamig	malamig	malaˈmiɡ
puno	puno	puˈnoʔ
bago	bago	ˈbaɡo
luma	luma	ˈlumaʔ
mabuti	mabuti	maˈbuti
masama	masama	
bulok	bulok	buˈlok
marumi	marumi	maɾuˈmi
tuwid	tuwid	tuˈid
bilog	bilog	
matulis	matulis	maˈtulis
mapurol	mapurol	mapuˈɾol
makinis	makinis	maˈkinis
basa	basa	ˈbasa
tuyo	tuyo	tuˈjoʔ
tama	tama	ˈtamaʔ
malapit	malapit	maˈlapit
malayo	malayo	
kanan	kanan	ˈkanan
kaliwa	kaliwa	kaliˈwaʔ
sa	sa	sa
sa	sa	sa
kasama	kasama	kaˈsama
at	at	ʔat
kung	kung	kuŋ
dahil	dahil	ˈdahil
pangalan	pangalan	paˈŋalan