ob	ob	ob
ol	ol	
om	om	
obs	obs	
ols	ols	
ons	ons	
atos	atos	
etos	etos	
is	is	
us	us	
kin	kin	
kis	kis	
kiöpo	kiöpo	
kiüpo	kiüpo	
lio	lio	liˈo
no	no	
valik	valik	
mödik	mödik	
anik	anik	
nemödik	nemödik	
votik	votik	
bal	bal	
tel	tel	
kil	kil	
fol	fol	
lul	lul	
gretik	gretik	
lunik	lunik	luˈnik
vidik	vidik	
bigik	bigik	
vetik	vetik	
smalik	smalik	
brefik	brefik	bre.ˈfik
nabik	nabik	
slenik	slenik	
vom	vom	
man	man	man
men	men	men
cil	cil	t͡ʃil
jimatan	jimatan	ʃi.maˈtan
himatan	himatan	hi.ma.ˈtan
mot	mot	
fat	fat	fat
nim	nim	nim
fit	fit	fit
böd	böd	bød
dog	dog	doɡ
puf	puf	
snek	snek	snek
vum	vum	
bim	bim	bim
fot	fot	
staf	staf	
fluk	fluk	fluk
sid	sid	
bled	bled	
vul	vul	
jal	jal	
flor	flor	
yeb	yeb	
jain	jain	
skin	skin	
mit	mit	
blud	blud	
bom	bom	bom
pin	pin	
nög	nög	
hon	hon	
göb	göb	
plüm	plüm	plym
her	her	
kap	kap	
lil	lil	
log	log	
nud	nud	nud
mud	mud	mud
tut	tut	
lineg	lineg	
nuel	nuel	
fut	fut	
lög	lög	
kien	kien	
nam	nam	nam
flitäm	flitäm	fli.ˈtɛm
bälid	bälid	bɛˈlid
ninäms	ninäms	
nük	nük	
bäk	bäk	bɛk
blöt	blöt	
lad	lad	
foad	foad	
drinön	drinön	
fidön	fidön	
beitön	beitön	be.i.ˈtøn
sügön	sügön	
spukön	spukön	
sputön	sputön	
bladön	bladön	
natemön	natemön	
smilön	smilön	
logön	logön	
lilön	lilön	
nolön	nolön	
tikön	tikön	tiˈkøn
smeilön	smeilön	
dredön	dredön	
slipön	slipön	sli.ˈpøn
lödön	lödön	
deadön	deadön	de.a.ˈdøn
deidön	deidön	de.i.ˈdøn
komipön	komipön	
yagön	yagön	jaˈɡøn
flapön	flapön	flaˈpøn
kötön	kötön	
slitön	slitön	
dägön	dägön	
kratön	kratön	
jüpön	jüpön	
svimön	svimön	
flitön	flitön	fli.ˈtøn
golön	golön	ɡoˈløn
kömön	kömön	
seatön	seatön	
seadön	seadön	
stanön	stanön	
flekön	flekön	fleˈkøn
falön	falön	
givön	givön	
kipön	kipön	kiˈpøn
knibön	knibön	
röbön	röbön	
lavön	lavön	
kluinön	kluinön	
tirön	tirön	
joikön	joikön	
jedön	jedön	
tanön	tanön	
nägön	nägön	
nümädön	nümädön	
sagön	sagön	
kanitön	kanitön	
pledön	pledön	
flotön	flotön	
flumön	flumön	
flodön	flodön	
svelikön	svelikön	
sol	sol	
mun	mun	
stel	stel	stel
vat	vat	
rein	rein	ɾeˈin
flumed	flumed	fluˈmed
lak	lak	
mel	mel	
sal	sal	
ston	ston	ston
sab	sab	
püf	püf	
tail	tail	
lefog	lefog	
fog	fog	
sil	sil	sil
vien	vien	
nif	nif	
glad	glad	
smok	smok	
fil	fil	
zen	zen	t͡sen
filön	filön	
veg	veg	
bel	bel	
redik	redik	re.ˈdik
grünik	grünik	ɡɾy.ˈnik
yelovik	yelovik	je.lo.ˈvik
vietik	vietik	
blägik	blägik	
neit	neit	neˈit
del	del	
yel	yel	
vamik	vamik	
koldik	koldik	
fulik	fulik	
nulik	nulik	
bäldik	bäldik	bɛlˈdik
gudik	gudik	ɡu.ˈdik
badik	badik	
puridik	puridik	
miotik	miotik	
stedälik	stedälik	
klöpik	klöpik	
japik	japik	
dofik	dofik	
smudik	smudik	
luimik	luimik	
sägik	sägik	
verätik	verätik	
nilü	nilü	
fagik	fagik	
detik	detik	
nedetik	nedetik	
tö	tö	
in	in	
ko	ko	
e	e	
if	if	
bi	bi	
nem	nem	