nga	nga	
phi	phi	
i	i	
ngi	ngi	
phi	phi	
ki	ki	
une	une	
various	various	
hangne	hangne	
various	various	
uno	uno	
uei	uei	
hangno	hangno	
lano	lano	
kumno	kumno	
ym	ym	
baroh	baroh	baroʔ
bun	bun	
katto-katne	katto-katne	
khyndiat	khyndiat	
		
wei	wei	
ar	ar	
laj	laj	
saw	saw	
san	san	
		
jrong	jrong	
iar	iar	
rben/ryben	rben/ryben	
khia	khia	
rit	rit	
lyngkot	lyngkot	
khim	khim	
stang	stang	
kynthei	kynthei	
rangbah	rangbah	
bynriew	bynriew	bnrew
khun	khun	
ka tnga	ka tnga	
u tnga	u tnga	
kmie	kmie	
kpa	kpa	
mrad	mrad	mraːt̚
dohkha	dohkha	
sim	sim	
ksew	ksew	
ksi	ksi	
bsein	bsein	
khniang	khniang	
dieng	dieng	
khlaw	khlaw	
diengduh	diengduh	
soh	soh	
symbai	symbai	
sla	sla	
tynrai	tynrai	
snep	snep	
syntiew	syntiew	
phlang	phlang	
tyllai	tyllai	
snieh	snieh	
doh	doh	
snam	snam	
shyieng	shyieng	
khlein	khlein	
pylleng	pylleng	
reng	reng	
tdong	tdong	t̪dɔŋ
sner	sner	
shniuh	shniuh	
khlieh	khlieh	
shkor	shkor	
khmat	khmat	
khmut	khmut	
ktien	ktien	
bniat	bniat	
thylliej	thylliej	
tyrsim	tyrsim	
kjat	kjat	
kjat	kjat	
khohsiew	khohsiew	
kti	kti	
thapniang	thapniang	
kpoh	kpoh	
snier	snier	
ryndang	ryndang	
ingdong	ingdong	
shadem	shadem	
dohnud	dohnud	
dohnud	dohnud	
dih	dih	
bam	bam	
dait	dait	
buin	buin	
biah	biah	
prie	prie	
pyrsut	pyrsut	
ring mynsiem	ring mynsiem	
rkhie	rkhie	
iohi/ïohi	iohi/ïohi	
iohsngew/ïohsngew	iohsngew/ïohsngew	
tip	tip	tɪp
pyrkhat	pyrkhat	
		
sheptieng	sheptieng	
thiah	thiah	
im	im	
iap/ïap	iap/ïap	
pyniap	pyniap	
iashoh	iashoh	
beh	beh	
shoh	shoh	
ot	ot	
phiah	phiah	
dung	dung	
trud	trud	
tih	tih	
jngi	jngi	
her	her	
ïaid	ïaid	
wan	wan	
thiah	thiah	
shong	shong	
ieng/ïeng	ieng/ïeng	
kyrtiang	kyrtiang	
ur	ur	
ai	ai	
bat	bat	
kshot	kshot	
		
sait	sait	
niad	niad	
sút	sút	
khynniat	khynniat	
kawang	kawang	
khum	khum	
suh	suh	
dondor	dondor	
ong	ong	
rwai	rwai	
lehkai	lehkai	
per	per	
tuid	tuid	
		
at	at	
sngi	sngi	
bynai	bynai	
khlur	khlur	
um	um	
slap	slap	
wah	wah	waːʔ
pung	pung	
duriaw	duriaw	
mluh	mluh	
maw	maw	
shyiap	shyiap	
pumpum	pumpum	
khyndew	khyndew	
lyoh	lyoh	
lyoh	lyoh	
bneng	bneng	
lyer	lyer	
ior	ior	
thah	thah	t̪ʰaːʔ
tdem	tdem	
ding	ding	
dpei	dpei	
thang	thang	
surok	surok	
lum	lum	
saw	saw	
jyrngam	jyrngam	
stem	stem	
lieh	lieh	leːʔ
iong	iong	
miet	miet	
sngi	sngi	
snem	snem	
syaid	syaid	
khriat	khriat	
dap	dap	
thymmai	thymmai	
rim	rim	
bha	bha	
sniew	sniew	
pyut	pyut	
tngit	tngit	
beit	beit	
pyllun	pyllun	
nep	nep	
		
jlih	jlih	
iong	iong	
rkhiang	rkhiang	
		
		
		
		
		
		
		
		
		
		
		
		