jIH	jIH	dʒɪx
SoH	SoH	ʂox
ghaH	ghaH	ɣɑx
maH	maH	mɑx
tlhIH	tlhIH	t͡ɬɪx
chaH	chaH	t͡ʃɑx
-vam	-vam	-vɑm
-vetlh	-vetlh	-vɛt͡ɬ
naDev	naDev	nɑˈɖɛv
pa'	pa'	pʰɑʔ
Iv	Iv	
nuq	nuq	nuqʰ
nuqDaq	nuqDaq	nuqʰ.ɖɑqʰ
ghorgh	ghorgh	ɣorɣ
chay'	chay'	t͡ʃɑjʔ
-be'	-be'	-bɛʔ
Hoch	Hoch	xot͡ʃ
law'	law'	lɑwʔ
op	op	
puS	puS	pʰuʂ
latlh	latlh	lɑt͡ɬ
wa'	wa'	wɑʔ
cha'	cha'	t͡ʃɑʔ
wej	wej	wɛd͡ʒ
loS	loS	loʂ
vagh	vagh	vɑɣ
tIn	tIn	tʰɪn
tIq	tIq	tʰɪqʰ
vaS	vaS	vɑʂ
jeD	jeD	d͡ʒɛɖ
ugh	ugh	
mach	mach	mɑt͡ʃ
run	run	run
lang	lang	lɑŋ
lang	lang	lɑŋ
be'	be'	
loD	loD	loɖ
ghot	ghot	ɣotʰ
puq	puq	pʰuqʰ
be'nal	be'nal	bɛʔˈnɑl
loDnal	loDnal	loɖˈnɑl
SoS	SoS	ʂoʂ
vav	vav	vɑv
Ha'DIbaH	Ha'DIbaH	xɑʔ.ɖɪ.bɑx
ghotI'	ghotI'	ɣoˈtʰɪʔ
bo'Degh	bo'Degh	boʔˈɖɛɣ
		
		
ghargh	ghargh	ɣɑrɣ
ghargh	ghargh	ɣɑrɣ
Sor	Sor	ʂor
ngem	ngem	ŋɛm
naQHom	naQHom	nɑq͡χ.xom
naH	naH	nɑx
raS'IS	raS'IS	rɑʂˈʔɪʂ
por	por	pʰor
oQqar	oQqar	
		
InSong	InSong	
magh	magh	mɑɣ
tlhegh	tlhegh	t͡ɬɛɣ
DIr	DIr	ɖɪr
Ha'DIbaH	Ha'DIbaH	xɑʔ.ɖɪ.bɑx
Iw	Iw	
Hom	Hom	xom
tlhagh	tlhagh	t͡ɬɑɣ
QIm	QIm	q͡χɪm
pu'	pu'	pʰuʔ
tlhuQ	tlhuQ	t͡ɬuq͡χ
bo	bo	bo
pob	pob	pʰob
nach	nach	nɑt͡ʃ
teS	teS	tʰɛʂ
mIn	mIn	mɪn
ghIch	ghIch	ɣɪt͡ʃ
nuj	nuj	nud͡ʒ
Ho'	Ho'	xoʔ
jat	jat	d͡ʒɑtʰ
nItlhpach	nItlhpach	nɪt͡ɬˈpʰɑt͡ʃ
qam	qam	qʰɑm
uS	uS	
qIv	qIv	qʰɪv
ghop	ghop	ɣopʰ
tel	tel	tʰɛl
chor	chor	t͡ʃor
		
mong	mong	moŋ
Dub	Dub	ɖub
ngob'at	ngob'at	
tIq	tIq	tʰɪqʰ
chej	chej	t͡ʃɛd͡ʒ
tlhutlh	tlhutlh	t͡ɬut͡ɬ
Sop	Sop	ʂopʰ
chop	chop	t͡ʃopʰ
rem	rem	
tlhIS	tlhIS	
em	em	
jo'	jo'	d͡ʒoʔ
tlhuH	tlhuH	t͡ɬux
Hagh	Hagh	xɑɣ
legh	legh	lɛɣ
Qoy	Qoy	q͡χoj
Sov	Sov	ʂov
Qub	Qub	q͡χub
largh	largh	lɑrɣ
-vIp	-vIp	-vɪpʰ
Qong	Qong	q͡χoŋ
yIn	yIn	jɪn
Hegh	Hegh	xɛɣ
HoH	HoH	xox
Suv	Suv	ʂuv
wam	wam	wɑm
qIp	qIp	qʰɪpʰ
pe'	pe'	pʰɛʔ
wav	wav	wɑv
DuQ	DuQ	ɖuq͡χ
lot	lot	lotʰ
tlhan	tlhan	
Qal	Qal	q͡χɑl
puv	puv	pʰuv
yIt	yIt	jɪtʰ
chol	chol	t͡ʃol
Qot	Qot	q͡χotʰ
ba'	ba'	bɑʔ
Qam	Qam	q͡χɑm
tlhe'	tlhe'	t͡ɬɛʔ
pum	pum	pʰum
nob	nob	nob
uch	uch	
ngaH	ngaH	ŋɑx
		
Say'moH	Say'moH	ʂɑjʔ.mox
		
Hoq	Hoq	xoqʰ
yuv	yuv	juv
vo'	vo'	voʔ
bagh	bagh	bɑɣ
		
togh	togh	tʰoɣ
jatlh	jatlh	d͡ʒɑt͡ɬ
bom	bom	bom
reH	reH	rex
al	al	
ghIt	ghIt	ɣɪtʰ
taDmoH	taDmoH	tʰɑɖ.mox
lun	lun	
jul	jul	d͡ʒul
maS	maS	mɑʂ
Hov	Hov	xov
bIQ	bIQ	bɪq͡χ
SIS	SIS	ʂɪʂ
bIQtIq	bIQtIq	bɪq͡χˈtʰɪqʰ
ngeng	ngeng	ŋɛŋ
		
		
nagh	nagh	nɑɣ
Do'ol	Do'ol	ɖoˈʔol
Say'qIS	Say'qIS	
lam	lam	lɑm
eng	eng	
vI'laS	vI'laS	vɪʔˈlɑʂ
chal	chal	t͡ʃɑl
SuS	SuS	ʂuʂ
peD	peD	pʰɛɖ
chuch	chuch	t͡ʃut͡ʃ
tlhIch	tlhIch	t͡ɬɪt͡ʃ
qul	qul	qʰul
tIpqan	tIpqan	
meQ	meQ	mɛq͡χ
taw	taw	tʰɑw
HuD	HuD	xuɖ
Doq	Doq	ɖoqʰ
SuD	SuD	ʂuɖ
SuD	SuD	ʂuɖ
chIS	chIS	t͡ʃɪʂ
qIj	qIj	qʰɪd͡ʒ
ram	ram	rɑm
jaj	jaj	
DIS	DIS	ɖɪʂ
ghun	ghun	ɣun
bIr	bIr	bɪr
buy'	buy'	bujʔ
chu'	chu'	t͡ʃuʔ
ngo'	ngo'	ŋoʔ
QaQ	QaQ	q͡χɑq͡χ
qab	qab	qʰɑb
non	non	non
lam	lam	lɑm
wan	wan	wɑn
rutlh	rutlh	rut͡ɬ
jej	jej	d͡ʒɛd͡ʒ
jejHa'	jejHa'	d͡ʒɛd͡ʒ.xɑʔ
Hab	Hab	xɑb
yIQ	yIQ	jɪq͡χ
QaD	QaD	q͡χɑɖ
lugh	lugh	luɣ
Sum	Sum	ʂum
Hop	Hop	xopʰ
nIH	nIH	nɪx
poS	poS	pʰoʂ
-Daq	-Daq	-ɖɑqʰ
-Daq	-Daq	-ɖɑqʰ
		
je	je	d͡ʒɛ
-chugh	-chugh	-t͡ʃuɣ
-mo'	-mo'	-moʔ
pong	pong	pʰoŋ