eg	eg	eː
tú	tú	tʰʉuː(w)
hann	hann	
vit	vit	viːt
tit	tit	tiːt
teir	teir	tʰaiːɹ
hesin	hesin	
hasin	hasin	
her	her	heːɹ
har	har	
hvør	hvør	kvøːr
hvat	hvat	kvɛaːʰt
hvar	hvar	kʰvɛaːɹ
nær	nær	nɛaːɹ
hvussu	hvussu	kʰvʊsːʊ
ikki	ikki	ˈɪʰtʃːɪ
alt	alt	al̥t
nógvir	nógvir	
nakrir	nakrir	ˈnakrɪr
fáir	fáir	ˈfɔajɪr
annar	annar	
ein	ein	ain
tveir	tveir	tvaiːɹ
tríggir	tríggir	trʊdʒɪr
fýra	fýra	ˈfʊiːɹa
fimm	fimm	fɪmː
stórur	stórur	ˈstɔuːɹʊɹ
langur	langur	ˈlɛŋkʊɹ
breiður	breiður	ˈpɹaijʊɹ
tjúkkur	tjúkkur	ˈt͡ʃʰʏʰkːʊɹ
tungur	tungur	
lítil	lítil	
stuttur	stuttur	
trongur	trongur	
klænur	klænur	
kona	kona	ˈkʰoːna
maður	maður	ˈmɛaːvʊɹ
menniskja	menniskja	
barn	barn	ˈpatn
kona	kona	ˈkʰoːna
maður	maður	ˈmɛaːvʊɹ
móðir	móðir	ˈmɔuwɪr
faðir	faðir	ˈfɛaːjɪɹ
djór	djór	t͡ʃɔuːr
fiskur	fiskur	ˈfɪskʊɹ
fuglur	fuglur	
hundur	hundur	ˈhʊntʊɹ
lús	lús	lʉuːs
slanga	slanga	
ormur	ormur	
træ	træ	tɹɛaː
skógur	skógur	
keppur	keppur	
frukt	frukt	
fræ	fræ	fɹɛaː
blað	blað	blɛaː
rót	rót	ɹɔuːt
børkur	børkur	ˈpœɹ̥kʊɹ
blóma	blóma	ˈblɔuma
gras	gras	kɹɛaːs
reip	reip	
húð	húð	
kjøt	kjøt	t͡ʃʰøːʰt
blóð	blóð	plɔuːw
bein	bein	bain
feitt	feitt	faiʰtː
egg	egg	ɛkː
horn	horn	hɔtn
hali	hali	ˈhɛaːlɪ
fjøður	fjøður	ˈfjøːvʊɹ
hár	hár	hɔaːɹ
høvd	høvd	hœtː
oyra	oyra	ˈɔira
eyga	eyga	ˈɛiːja
nøs	nøs	nøːs
munnur	munnur	ˈmʊnːʊɹ
tonn	tonn	tʰɔnː
tunga	tunga	ˈtʰʊŋka
negl	negl	
fótur	fótur	ˈfɔuːtʊɹ
bein	bein	bain
knæ	knæ	knɛaː
hond	hond	hɔnt
vongur	vongur	ˈvɔŋkʊɹ
magi	magi	ˈmɛaːjɪ
tarmur	tarmur	ˈtʰaɹmʊɹ
hálsur	hálsur	ˈhal̥sʊɹ
ryggur	ryggur	ˈɹɪkːʊɹ
bróst	bróst	brœst
hjarta	hjarta	ˈjaɻ̊ʈa
livur	livur	ˈliːvʊɹ
drekka	drekka	ˈtɾɛʰkːa
eta	eta	ˈeːʰta
bíta	bíta	
súgva	súgva	
spýta	spýta	
spýggja	spýggja	
blása	blása	
anda	anda	
læa	læa	ˈle̞ːa
síggja	síggja	ˈsʊt͡ʃːa
hoyra	hoyra	
vita	vita	
hugsa	hugsa	
lukta	lukta	
ræðast	ræðast	
sova	sova	
liva	liva	
doyggja	doyggja	ˈtɔt͡ʃːa
drepa	drepa	
stríða	stríða	
jaga	jaga	ˈjeːa
sláa	sláa	
skera	skera	
klúgva	klúgva	
stinga	stinga	
klóra	klóra	
grava	grava	
svimja	svimja	
flúgva	flúgva	ˈflɪkva
ganga	ganga	ˈkɛŋka
koma	koma	
liggja 	liggja 	
sita	sita	
standa	standa	ˈstanta
snúgva	snúgva	ˈsnɪɡva
fella	fella	ˈfɛdla
geva	geva	t͡ʃeːʋa
halda	halda	
kroysta	kroysta	ˈkrɔiʃta
gníggja	gníggja	ˈknʊit͡ʃːa
vaska	vaska	
turka	turka	
toga	toga	
skumpa	skumpa	
kasta	kasta	kʰasta
binda	binda	ˈpɪnta
seyma	seyma	
telja	telja	
siga	siga	siːja
syngja	syngja	
spæla	spæla	
flóta	flóta	
streyma	streyma	
frysta	frysta	ˈfɾɪsta
bólgna	bólgna	ˈpœlna
sól	sól	sɔuːl
máni	máni	ˈmɔɑːnɪ
stjørna	stjørna	ˈʃœtna
vatn	vatn	vaʰtn̥
regna	regna	
á	á	ɔaː
vatn	vatn	vaʰtn̥
sjógvur	sjógvur	ˈʃɛkvʊɹ
salt	salt	sal̥t
steinur	steinur	ˈstaɪnʊɹ
sandur	sandur	ˈsantʊɹ
dust	dust	
mold	mold	mɔlt
skýggj	skýggj	skʊt͡ʃː
mjørki	mjørki	ˈmjœɹ̥tʃɪ
himmal	himmal	ˈhɪmːal
vindur	vindur	ˈvɪntʊɹ
kavi	kavi	ˈkʰɛaːvɪ
ísur	ísur	ˈʊiːsʊɹ
roykur	roykur	ˈɹɔiːjkʊɹ
eldur	eldur	ɛltʊɹ
øska	øska	ˈœska
brenna	brenna	ˈpɾɛnːa
vegur	vegur	ˈveːvʊɹ
fjall	fjall	fjatl
reyður	reyður	
grønur	grønur	
gulur	gulur	ˈkuːlʊɹ
hvítur	hvítur	ˈkvʊiːjtʊɹ
svartur	svartur	ˈsvaɻ̥ʈʊɹ
nátt	nátt	nɔʰtː
dagur	dagur	ˈtɛaːvʊɹ
ár	ár	ɔaːɹ
heitur	heitur	
kalt	kalt	
fullur	fullur	ˈfʊtlʊɹ
nýggjur	nýggjur	nʊt͡ʃːʊɹ
gamal	gamal	kɛaːmal
góður	góður	ˈkɔuːwʊɹ
ringur	ringur	
rotin	rotin	
skitin	skitin	
beinur	beinur	
rundur	rundur	
hvassur	hvassur	ˈkvasːʊɹ
óhvassur	óhvassur	ˈɔukvasːʊr
slættur	slættur	ˈslaʰtːʊɹ
vátur	vátur	
turrur	turrur	
rættur	rættur	
nær	nær	nɛaːɹ
fjarur	fjarur	
høgra	høgra	
vinstra	vinstra	
hjá	hjá	t͡ʃʰɔɑː
í	í	ʊiː
við	við	viː
og	og	oː
um	um	ʊmː
tí	tí	tʰʊiː
navn	navn	naun