ñaap	ñaap	
may	may	
ñipáa	ñipáa	
páñaap	páñaap	
ñipáa chaaú	ñipáa chaaú	
ñipáat	ñipáat	
mí	mí	
ñiaat	ñiaat	
míl	míl	
ñák	ñák	
maa	maa	
kwit	kwit	
abel	abel	
mat piim	mat piim	
pojooy	pojooy	
mat	mat	
kospíl	kospíl	
ulooy máto	ulooy máto	
set	set	
teelt	teelt	
		
msíg	msíg	
juwak	juwak	
jmik	jmik	
mnak	mnak	
salchipam	salchipam	
tay	tay	
kíss	kíss	
teeyp	teeyp	
kuteey	kuteey	
mechaa maay	mechaa maay	
mudit	mudit	
nmooj	nmooj	
		
jo'on	jo'on	
kekóo	kekóo	
kumeey	kumeey	
ipaa	ipaa	
sáaup	sáaup	
		
		
eñoo	eñoo	
esñoo	esñoo	
tukuipaay	tukuipaay	
teet	teet	
tuwálo	tuwálo	
that	that	
jlpok	jlpok	
uwi'	uwi'	
		
tajak	tajak	
jaal jak	jaal jak	
lpá	lpá	
paay	paay	
yíit	yíit	
smak	smak	
ousmáa maat	ousmáa maat	
yiaal	yiaal	
piyáuup	piyáuup	
semeel	semeel	
j’ñieel	j’ñieel	
kojaan	kojaan	
jak	jak	
kujat	kujat	
ják	ják	
		
jmá yítl	jmá yítl	
kwa	kwa	
pelsa'	pelsa'	
tajpa aayu	tajpa aayu	
iy unmí	iy unmí	
iy	iy	
smákal	smákal	
yuu	yuu	
phí	phí	
ha'	ha'	
yaw	yaw	
há paal	há paal	
		
miy	miy	
miy ijá	miy ijá	
miy pók	miy pók	
sal	sal	
wálu	wálu	
pa'	pa'	
pmaay guajú	pmaay guajú	
chimi’ jak	chimi’ jak	
yikók sí	yikók sí	
smiil	smiil	
koti’p	koti’p	
leepé	leepé	
chee	chee	
tmaa	tmaa	
chía	chía	
		
		
		
		
		
chiin	chiin	
saaw	saaw	
kuee	kuee	
		
elti paatu	elti paatu	
		
		
smaa	smaa	
wa’y	wa’y	
pí	pí	
eñoo	eñoo	
eñoop	eñoop	
jkwigu	jkwigu	
		
jkáaw	jkáaw	
		
		
		
		
		
		
aaw	aaw	
jaa	jaa	
p’páa	p’páa	
jowaa	jowaa	
		
		
j’paam	j’paam	
juwee	juwee	
		
		
		
		
		
ajñaat	ajñaat	
ulchin	ulchin	
cha’ki	cha’ki	
		
p’jpaab u’	p’jpaab u’	
tetseebo	tetseebo	
há maal	há maal	
ltechaja’y	ltechaja’y	
		
		
		
		
		
eñiaay	eñiaay	
ja’la’	ja’la’	
msi'	msi'	
ja'	ja'	
kwiiy	kwiiy	
ja’ kos’jiin	ja’ kos’jiin	
ja’ jpí tay	ja’ jpí tay	
jaʼ tay	jaʼ tay	
kwi	kwi	
ujá	ujá	
		
maat sa’ mak	maat sa’ mak	
maat	maat	
		
		
ma’y	ma’y	
ja’k	ja’k	
k’mtiiy	k’mtiiy	
smis	smis	
chuu	chuu	
a'aw	a'aw	
ku’pal	ku’pal	
		
uña’	uña’	
weey	weey	
kwal	kwal	
msoow	msoow	
ku’seey	ku’seey	
msaap	msaap	
ñleeg	ñleeg	
téey	téey	
eñiaay	eñiaay	
maat	maat	
mgaaw	mgaaw	
jschiaak	jschiaak	
		
		
ku'	ku'	
mgaay	mgaay	
ulooy	ulooy	
		
jpill	jpill	
		
		
yaaw yuu jooy	yaaw yuu jooy	
		
		
		
saay	saay	
		
yaay kuwaa yío	yaay kuwaa yío	
		
chpeeyp	chpeeyp	
		
		
		
		
		
		
		
		