naja	naja	ˈnaha
taja	taja	ˈtaha
yaja	yaja	ˈjaha
tejemet	tejemet	teˈhemet
anmejemet	anmejemet	anmeˈhemet
yejemet	yejemet	jeˈhemet
ini	ini	
uni	uni	
nikan	nikan	
unkan	unkan	
ká	ká	
Tay	Tay	
kan	kan	
ijkwak	ijkwak	
ken	ken	
teasu	teasu	
muchi	muchi	
miak	miak	
sejse	sejse	
chiupi	chiupi	
seyuk	seyuk	
se	se	ˈseː
ume	ume	ˈuːme
yey	yey	jeːj
nawi	nawi	ˈnaːwi
makwil	makwil	ˈmaːkʷil
wey	wey	
weyak	weyak	
patawak	patawak	
chamawak	chamawak	
etek	etek	
chikitik	chikitik	
kutu	kutu	
uchulnaj	uchulnaj	
pitzawak	pitzawak	
siwat	siwat	ˈsiwaːt
takat	takat	
takat	takat	
kunet	kunet	ˈkuneːt
-siwaw	-siwaw	
-shulejyu	-shulejyu	
-nan	-nan	
tata	tata	
takwalmet	takwalmet	
michin	michin	ˈmit͡ʃiŋ
tutut	tutut	ˈtuːtut
pelu	pelu	ˈpeːlu
atimet	atimet	
kuat	kuat	
kwilin	kwilin	ˈkʷiliŋ
kwawit	kwawit	ˈkʷawit
kwawital	kwawital	
kwawit	kwawit	ˈkʷawit
-takil	-takil	
ish	ish	
iswat	iswat	
nelwat	nelwat	
ewat	ewat	
shuchit	shuchit	ˈʃuːt͡ʃit
sakat	sakat	
mekat	mekat	ˈmekat
kwetashti	kwetashti	
nakat	nakat	
esti	esti	
umit	umit	
-tumakka	-tumakka	
teksisti	teksisti	
-kwawyu	-kwawyu	
-kwitapil	-kwitapil	
-ujmiyu	-ujmiyu	
-tzunkal	-tzunkal	
tzuntekumat	tzuntekumat	
-nakas	-nakas	
-ish	-ish	
-yak	-yak	
-ten	-ten	
-tan	-tan	
-nenepil	-nenepil	
istit	istit	
-ikshi	-ikshi	
-metzkuyu	-metzkuyu	
-tewajka	-tewajka	
-mey	-mey	
-ejtapal	-ejtapal	
-ijti	-ijti	
-kwitashkul	-kwitashkul	
-kechkuyu	-kechkuyu	
-teputz	-teputz	
-elpan	-elpan	
-yulu	-yulu	
-eltapach	-eltapach	
uni	uni	
kʷa	kʷa	
tankwa	tankwa	
chichina	chichina	
chijcha	chijcha	
isuta	isuta	
ishpitza	ishpitza	
ijyukwi	ijyukwi	
wetzka	wetzka	
ita	ita	
kaki	kaki	
mati	mati	ˈmati
yultaketza	yultaketza	
ijnekwi	ijnekwi	
makasi	makasi	
kuchi	kuchi	
nemi	nemi	ˈnemi
miki	miki	ˈmiki
miktia	miktia	mikˈti(j)a
suma	suma	
itzkia	itzkia	
chalua	chalua	
kutuna	kutuna	
tzayana	tzayana	
tzunteki	tzunteki	
wawana	wawana	
talichkwa	talichkwa	
manelua	manelua	
patani	patani	
nejnemi	nejnemi	
witz	witz	wiːt͡s
muteka	muteka	
mutalia	mutalia	
muketza	muketza	
ishkwepa	ishkwepa	
wetzi	wetzi	
maka	maka	ˈmaka
piya	piya	ˈpija
pitzinia	pitzinia	
puyawa	puyawa	
paka	paka	
pupua	pupua	
tilana	tilana	
ishtupewa	ishtupewa	
tamuta	tamuta	
ilpia	ilpia	
ijtzuma	ijtzuma	
puwa	puwa	
ina	ina	ˈiːna
takwika	takwika	
awiltia	awiltia	
tzunpanu	tzunpanu	
mutalua	mutalua	
seseya	seseya	
suluni	suluni	
tunal	tunal	ˈtuːnal
metzti	metzti	ˈmeːt͡sti
sital	sital	ˈsiːtal
at	at	at
wetzti at	wetzti at	
apan	apan	ˈapaŋ
lagoj	lagoj	
weyat	weyat	
istat	istat	
tet	tet	
ashal	ashal	
tewti	tewti	
tal	tal	ˈtaːl
mishti	mishti	ˈmiʃti
mishti	mishti	ˈmiʃti
wilkal	wilkal	
ejekat	ejekat	eˈheɡat
nievej	nievej	
sekti	sekti	
pukti	pukti	
tit	tit	tiːt
neshti	neshti	
tatia	tatia	
ujti	ujti	
tepet	tepet	
chiltik	chiltik	ˈt͡ʃiːltik
shushuwik	shushuwik	
tultik	tultik	
istak	istak	
tiltik	tiltik	
tayuwa	tayuwa	
tunal	tunal	ˈtuːnal
shiwit	shiwit	
tutunik	tutunik	
sesek	sesek	
tentuk	tentuk	
yankwik	yankwik	
pala	pala	
yek	yek	ˈjeːk
inteyek	inteyek	
palantuk	palantuk	
puknaj	puknaj	
melaktik	melaktik	
ululnaj	ululnaj	
tamej	tamej	
tzuntulupu	tzuntulupu	
petztik	petztik	
ajwituk	ajwituk	
waktuk	waktuk	
melawak	melawak	
nawak	nawak	
wejka	wejka	
yekkan	yekkan	
ukse ladoj	ukse ladoj	
tik	tik	
tik	tik	
iwan	iwan	
wan	wan	waŋ
asu	asu	
ika	ika	
-tukay	-tukay	