ñuqa	ñuqa	ˈɲoqɑ
qam	qam	
pay	pay	paj
ñuqanchik	ñuqanchik	
qamkuna	qamkuna	
paykuna	paykuna	
kay	kay	
chay	chay	
kaypi	kaypi	
chaypi	chaypi	
pi	pi	
ima	ima	
may	may	
mayk'ap	mayk'ap	
imahina	imahina	
mana ...-chu	mana ...-chu	
tukuy	tukuy	
achka	achka	
tumpa	tumpa	
aslla	aslla	
huk	huk	
huk	huk	
iskay	iskay	
kimsa	kimsa	
tawa	tawa	
pichqa	pichqa	ˈpɪt͡ʃqɐ
hatun	hatun	
suni	suni	
kimra	kimra	
raku	raku	
llasa	llasa	
uchuy	uchuy	
chutu	chutu	
k'ichki	k'ichki	
ñañu	ñañu	
warmi	warmi	
qhari	qhari	
runa	runa	
irqi	irqi	
warmi	warmi	
qusa	qusa	
mama	mama	
tayta	tayta	
uywa	uywa	
challwa	challwa	
lluta	lluta	
allqu	allqu	
usa	usa	
mach'aqway	mach'aqway	
kuru	kuru	
sacha	sacha	
sachakuna	sachakuna	
kaspi	kaspi	
ruru	ruru	
muhu	muhu	
laqi	laqi	
sapi	sapi	
qara	qara	
wayta	wayta	ˈwajta
qura	qura	
waska	waska	
qara	qara	
aycha	aycha	
yawar	yawar	
tullu	tullu	
wira	wira	
runtu	runtu	
waqra	waqra	
chupa	chupa	
puru	puru	
chukcha	chukcha	
uma	uma	
rinri	rinri	
ñawi	ñawi	
sinqa	sinqa	
simi	simi	
kiru	kiru	
qallu	qallu	
sillu	sillu	
chaki	chaki	
chanka	chanka	
qunquri	qunquri	
maki	maki	
rapra	rapra	
wiksa	wiksa	
chunchul	chunchul	
kunka	kunka	
wasa	wasa	
qasqu	qasqu	
sunqu	sunqu	
kiwcha	kiwcha	
upyay	upyay	
mikhuy	mikhuy	
kaniy	kaniy	
chunqay	chunqay	
tuqay	tuqay	
aqtuy	aqtuy	
phukuy	phukuy	
samay	samay	
asiy	asiy	
rikuy	rikuy	
uyariy	uyariy	
yachay	yachay	
yuyay	yuyay	
mutkiy	mutkiy	
manchay	manchay	
puñuy	puñuy	
kawsay	kawsay	
wañuy	wañuy	
wañuchiy	wañuchiy	
awqay	awqay	
chakuy	chakuy	
maqay	maqay	
p'itiy	p'itiy	
laray	laray	
chusyay	chusyay	
aspiy	aspiy	
allay	allay	
wayt'ay	wayt'ay	
phaway	phaway	
puriy	puriy	
hamuy	hamuy	
sirikuy	sirikuy	
tiyakuy	tiyakuy	
sayariy	sayariy	
muyuy	muyuy	
urmay	urmay	
quy	quy	
tiyaway	tiyaway	
qapiy	qapiy	
kituy	kituy	
maqchiy	maqchiy	
chakichiy	chakichiy	
aysay	aysay	
tanqay	tanqay	
wichuy	wichuy	
watay	watay	
siray	siray	
yupay	yupay	
niy	niy	
takiy	takiy	
pukllay	pukllay	
tuytuy	tuytuy	
tinkukuy	tinkukuy	
qasay	qasay	
punkiy	punkiy	
inti	inti	
killa	killa	
quyllur	quyllur	
unu	unu	
para	para	
mayu	mayu	
qucha	qucha	
mama qucha	mama qucha	
kachi	kachi	
rumi	rumi	
t'iyu	t'iyu	
hallp'a	hallp'a	
allpa	allpa	
puyu	puyu	
phuya	phuya	
hawa	hawa	
wayra	wayra	
rit'i	rit'i	
qasa	qasa	
qusñi	qusñi	
nina	nina	
uchpa	uchpa	
rawray	rawray	
ñan	ñan	
urqu	urqu	
puka	puka	
qumir	qumir	
qillu	qillu	
yuraq	yuraq	
yana	yana	
tuta	tuta	
p'unchaw	p'unchaw	
wata	wata	
illi	illi	
chiri	chiri	
hunt'a	hunt'a	
musuq	musuq	
machu	machu	
kusa	kusa	
mana allin	mana allin	
ismusqa	ismusqa	
qanra	qanra	
chiqa	chiqa	
muyu	muyu	
kachi	kachi	
ruqu	ruqu	
lluspi	lluspi	
huq'u	huq'u	
chaki	chaki	
chanin	chanin	
sichpa	sichpa	
karu	karu	
paña	paña	
lluqi	lluqi	
-pi	-pi	pɪ
-pi	-pi	pɪ
-yuq	-yuq	joq
-wan	-wan	wæn
-pti-	-pti-	
-rayku	-rayku	
suti	suti	