		
		
		
		
		
		
		
		
		
		
		
		
		
		
		
		
		
		
		
		
		
		
		
		
		
		
		
		
		
		
		
čík'ana	čík'ana	
ptéčena	ptéčena	
		
zizípena	zizípena	
		
wičhášta	wičhášta	
wičhášta	wičhášta	
		
thawíču	thawíču	
hihnáku	hihnáku	
iná	iná	
até	até	
wamakhaškaŋ	wamakhaškaŋ	
hoǧáŋ	hoǧáŋ	
ziŋtkána	ziŋtkána	
šúŋka	šúŋka	
héya	héya	
		
wabdúna	wabdúna	
čháŋ	čháŋ	
		
čháŋ	čháŋ	
waskúyeča	waskúyeča	
sú	sú	
		
hútkhaŋ	hútkhaŋ	
čhaŋhá	čhaŋhá	
waȟčá	waȟčá	
pheží	pheží	
wíkhaŋ	wíkhaŋ	
há	há	
thadó	thadó	
wé	wé	
huhú	huhú	
wašíŋ	wašíŋ	
wítka	wítka	
hé	hé	
siŋté	siŋté	
wíyaka	wíyaka	
		
		
núŋǧe	núŋǧe	
ištá	ištá	
phasú	phasú	
í	í	
hí	hí	
čheží	čheží	
		
sí	sí	
hú	hú	
		
napé	napé	
ȟupáhu	ȟupáhu	
thezí	thezí	
šupé	šupé	
thahú	thahú	
		
makhú	makhú	
čhaŋté	čhaŋté	
phí	phí	
yatkÁŋ	yatkÁŋ	
yútA	yútA	
yaȟtákA	yaȟtákA	
yaǧópA	yaǧópA	
thaǧóša	thaǧóša	
hdépA	hdépA	
thaté	thaté	
niyÁ	niyÁ	
		
waŋyáŋkA	waŋyáŋkA	
naȟ’úŋ	naȟ’úŋ	
sdodyÁ	sdodyÁ	
		
ómna	ómna	
khokíphA	khokíphA	
ištíŋmA	ištíŋmA	
ní	ní	
t’Á	t’Á	
kté	kté	
khízA	khízA	
		
		
kaksÁ	kaksÁ	
kasdéčA	kasdéčA	
čhaphÁ	čhaphÁ	
		
k’Á	k’Á	
		
kiŋyÁŋ	kiŋyÁŋ	
máni	máni	
ú	ú	
		
		
		
		
		
		
		
		
		
		
		
		
		
		
		
		
		
		
		
		
		
		
		
		
		
		
		
		
		
		
bdé	bdé	
		
		
		
		
makȟábdu	makȟábdu	
makȟá	makȟá	
		
		
		
tȟaté	tȟaté	
		
		
		
pȟéta	pȟéta	
		
		
		
		
		
		
		
		
		
		
		
		
		
		
		
		
		
		
		
		
		
		
		
		
		
		
		
		
		
		
		
		
		
		
		
		
k’a	k’a	
		
		
		