		
		
		
		
		
		
		
		
káa	káa	
šée	šée	
pée	pée	
táatą	táatą	
howáįki	howáįki	
		
		
aží	aží	
záani	záani	
ochí	ochí	
hépe	hépe	
čóopa	čóopa	
ą́mą	ą́mą	
wį	wį	
ðǫǫpá	ðǫǫpá	
ðáabrį	ðáabrį	
tóopa	tóopa	
sáhtą	sáhtą	
htą́ka	htą́ka	
scece	scece	
lą́ąðe	lą́ąðe	
šooká	šooká	
skíke	skíke	
žįká	žįká	
čáahpa	čáahpa	
wahóšce	wahóšce	
bréhka	bréhka	
wakˀó	wakˀó	
níhka	níhka	
níhkašie	níhkašie	
žįká	žįká	
wakˀó	wakˀó	
níhka	níhka	
iihǫ́ [his m.]	iihǫ́ [his m.]	
iðáce [his f.]	iðáce [his f.]	
wacúhta	wacúhta	
hó	hó	
wažį́ka	wažį́ka	
šǫ́ke	šǫ́ke	
hée	hée	
wécˀa	wécˀa	
htamá	htamá	
žą́ą	žą́ą	
są́ą	są́ą	
žą́ąxe	žą́ąxe	
waskúe	waskúe	
súu	súu	
žąąpé	žąąpé	
žą́ą kˀą	žą́ą kˀą	
hį́įce	hį́įce	
laaská	laaská	
		
		
xúhaa	xúhaa	
htáa	htáa	
		
		
		
		
		
		
		
paha	paha	
		
nahtah	nahtah	
ehtah	ehtah	
pah	pah	
iha	iha	
iha	iha	
		
shagahah	shagahah	
sih	sih	
		
		
shagah	shagah	
		
		
		
tahu	tahu	
		
		
		
		
		
wanumbra	wanumbra	
		
		
		
		
		
		
		
		
		
		
		
		
		
		
		
		
		
		
		
		
		
		
		
		
		
		
		
		
		
		
		
		
		
hip'e	hip'e	
		
		
		
		
		
		
		
		
		
		
		
		
		
		
		
		
		
		
		
		
		
		
		
		
wanchiskah	wanchiskah	
		
		
		
		
		
		
		
		
		
mahah	mahah	
		
		
nonha	nonha	
		
pajah	pajah	
		
		
		
		
shugah	shugah	
		
sihah	sihah	
skah	skah	
saba	saba	
		
hompahe	hompahe	
		
		
		
		
		
		
		
		
		
		
		
		
		
		
		
		
		
		
		
		
		
		
		
		
		
		
		
		
		