enyaach	enyaach	
maach	maach	
puuch	puuch	
enyaawapch	enyaawapch	
menyaawapch	menyaawapch	
pupch	pupch	
peyaa	peyaa	
puu	puu	
peyii	peyii	
puy	puy	
maap	maap	
uuch	uuch	
maay	maay	
kumyum	kumyum	
meyuu	meyuu	
umaaw	umaaw	
nyaamat	nyaamat	
ehmiiy	ehmiiy	
marway	marway	
ehiink	ehiink	
kwa'hin	kwa'hin	
ehink	ehink	
hewuk	hewuk	
hemuk	hemuk	
chepup	chepup	
sawrrup	sawrrup	
iikuu	iikuu	
equll	equll	
all	all	
menuttk	menuttk	
wenah	wenah	
estik	estik	
meputtk	meputtk	
helyumk	helyumk	
kwalkwaal	kwalkwaal	
siny	siny	
iikwich	iikwich	
iipay	iipay	
elymaam	elymaam	
paasiny	paasiny	
paachuuy	paachuuy	
kuhkwany	kuhkwany	
paataat	paataat	
nyechehaatt	nyechehaatt	
chee	chee	
aashaa	aashaa	
ehatt	ehatt	
emilly	emilly	
ewii	ewii	
ill	ill	
ily	ily	
		
ily	ily	
		
esemay	esemay	
		
pehemaa	pehemaa	
haaseyall	haaseyall	
taps	taps	
esemay	esemay	
chekoot	chekoot	
ekwally	ekwally	
kukwaayp	kukwaayp	
ehwatt	ehwatt	
aq	aq	
weshay	weshay	
ur	ur	
ekwaa	ekwaa	
heyull	heyull	
lemis	lemis	
hellytaa	hellytaa	
hellytaa	hellytaa	
hemall	hemall	
eyiiw	eyiiw	
ehuu	ehuu	
aa	aa	
eyaaw	eyaaw	
enepall	enepall	
salyehwuuw	salyehwuuw	
emily	emily	
emily	emily	
mehetun	mehetun	
esally	esally	
wirewir	wirewir	
etuu	etuu	
pehaa	pehaa	
eyepuk	eyepuk	
hetat	hetat	
nyemaay	nyemaay	
iichih	iichih	
chepesii	chepesii	
wesii	wesii	
wemaa	wemaa	
chuukuw	chuukuw	
chepesii	chepesii	
chehutt	chehutt	
weyuuq	weyuuq	
hepesuuy	hepesuuy	
yaas	yaas	
uusay	uusay	
ewuuw	ewuuw	
yip	yip	
nur	nur	
iichaa	iichaa	
wehwii	wehwii	
meheyaay	meheyaay	
hemaa	hemaa	
nyewaayp	nyewaayp	
melay	melay	
aamuuch	aamuuch	
mat menyuup	mat menyuup	
wenyay	wenyay	
chetoo	chetoo	
aakatt	aakatt	
uuhwaq	uuhwaq	
uushaa	uushaa	
hesak	hesak	
wehwall	wehwall	
aapull	aapull	
weman	weman	
wamp	wamp	
weyiw	weyiw	
welyak	welyak	
wenak	wenak	
pehekwii	pehekwii	
apekwiilp	apekwiilp	
tuushup	tuushup	
winy	winy	
weyuuw	weyuuw	
uukwis	uukwis	
chehwar	chehwar	
allehwas	allehwas	
chemally	chemally	
aalul	aalul	
cheherii	cheherii	
wetom	wetom	
aannak	aannak	
peyuur	peyuur	
		
wii	wii	
echweyuuw	echweyuuw	
suunaarr	suunaarr	
		
wenuw	wenuw	
shemetii	shemetii	
waarp	waarp	
enyaa	enyaa	
hellyaa	hellyaa	
kwenmesaap	kwenmesaap	
ehaa	ehaa	
ekwiy	ekwiy	
ehaa kwenuw	ehaa kwenuw	
ehaa kwariw	ehaa kwariw	
ehaasilly	ehaasilly	
esily	esily	
ewily	ewily	
mes-haraay	mes-haraay	
empill	empill	
emat	emat	
ekwiiy	ekwiiy	
haamaa	haamaa	
emaay	emaay	
kuyaayp	kuyaayp	
aalap	aalap	
shemetii	shemetii	
uuhuy	uuhuy	
aaw	aaw	
empill	empill	
aaraw	aaraw	
uunyaa	uunyaa	
matetay	matetay	
ehwatt	ehwatt	
hepeshiw	hepeshiw	
ekwas	ekwas	
nemeshap	nemeshap	
nyilly	nyilly	
hunn	hunn	
enyaa	enyaa	
aany	aany	
		
hechuur	hechuur	
hup	hup	
ehay	ehay	
wenuuy	wenuuy	
ehan	ehan	
wellich	wellich	
weshah	weshah	
taketak	taketak	
halettuk	halettuk	
tepechuurp	tepechuurp	
werraaw	werraaw	
		
heleqay	heleqay	
ehar	ehar	
saay	saay	
ehan	ehan	
helyepay	helyepay	
ekur	ekur	
eyewiik	eyewiik	
kesark	kesark	
		
		
kuuyum	kuuyum	
may	may	
		
		
chehichf	chehichf	