nuga̲	nuga̲	
nu'i	nu'i	
nu'ä	nu'ä	
nugawi	nugawi	
nu'iwi	nu'iwi	
nu’u	nu’u	
nuna	nuna	
nu'ä	nu'ä	
nuwa	nuwa	
nu'bu̲	nu'bu̲	
togo	togo	
temu	temu	
ho'bu̲	ho'bu̲	
hä'mu̲	hä'mu̲	
hanja	hanja	
hin-	hin-	
ta̲t’i	ta̲t’i	
ndunthe	ndunthe	
naxtui	naxtui	
tx'u̲tho	tx'u̲tho	
ma ‘na	ma ‘na	
n'aha	n'aha	
yoho	yoho	
hñu	hñu	
goho	goho	
ku̲t’a	ku̲t’a	
dätä	dätä	
maki	maki	
nxidi	nxidi	
mpidi	mpidi	
hñu̲	hñu̲	
tx'u̲lo	tx'u̲lo	
tx'u̲ki	tx'u̲ki	
nts'it'i	nts'it'i	
nts'u̲t'i	nts'u̲t'i	
be̲hñä	be̲hñä	
ño̲ho̲	ño̲ho̲	
jä'i	jä'i	
bätsi	bätsi	
be̲hñä	be̲hñä	
ndo̲	ndo̲	
nänä	nänä	
tada	tada	
zu'we	zu'we	
hwä	hwä	
ts'ints'u̲	ts'ints'u̲	
tsat'yo	tsat'yo	
t'o	t'o	
pa̲	pa̲	
zu'we	zu'we	
zaa	zaa	
mbozaa	mbozaa	
ma̲i	ma̲i	
ixi	ixi	
nda̲	nda̲	
xi	xi	
yu̲	yu̲	
ma̲ts'i	ma̲ts'i	
do̲ni	do̲ni	
pasto	pasto	
nthähi	nthähi	
xifni	xifni	
ngo̲	ngo̲	
ji	ji	
ndo'yo	ndo'yo	
hnoho	hnoho	
mädo	mädo	
ndäni	ndäni	
ts'u̲	ts'u̲	
xi'ni	xi'ni	
xtä	xtä	
ñäxu̲mu	ñäxu̲mu	
zagu	zagu	
da̲	da̲	
xiñu	xiñu	
ne	ne	
ts'i	ts'i	
jähne	jähne	
xa̲	xa̲	
wa	wa	
xinthe	xinthe	
ñähmu	ñähmu	
ye̲	ye̲	
jwa	jwa	
xefo	xefo	
xafo	xafo	
yu̲ga̲	yu̲ga̲	
xu̲tha	xu̲tha	
ba	ba	
mu̲i	mu̲i	
ya	ya	
tsithe	tsithe	
tsi	tsi	
tsa	tsa	
juts’i	juts’i	
tsogi	tsogi	
e̲i	e̲i	
jwixt'i	jwixt'i	
nju̲xu̲hñä	nju̲xu̲hñä	
thede	thede	
nu	nu	
o̲de	o̲de	
ät’i	ät’i	
mbeni	mbeni	
yu̲ni	yu̲ni	
ntsu	ntsu	
ähä	ähä	
‘bui	‘bui	
tu	tu	
ho	ho	
ntuhni	ntuhni	
pe̲	pe̲	
fant’i	fant’i	
he̲ki	he̲ki	
he̲ni	he̲ni	
sut'i	sut'i	
xe̲t'i	xe̲t'i	
he̲t'i	he̲t'i	
ña̲the	ña̲the	
nsa̲ni	nsa̲ni	
‘yowa	‘yowa	
ehe	ehe	
‘be̲ni	‘be̲ni	
hudi	hudi	
ba̲i	ba̲i	
‘ba̲t'i	‘ba̲t'i	
ta̲gi	ta̲gi	
uni	uni	
hä	hä	
te̲'mi	te̲'mi	
koxt'i	koxt'i	
pet'e	pet'e	
thuki	thuki	
ju̲t'i	ju̲t'i	
tuki	tuki	
u̲ts'i	u̲ts'i	
tut'i	tut'i	
we̲ti	we̲ti	
pede	pede	
mä	mä	
tuhu	tuhu	
ñeni	ñeni	
hñe̲nts'i	hñe̲nts'i	
tihi	tihi	
ntse̲	ntse̲	
hneni	hneni	
hyadi	hyadi	
zänä	zänä	
tso̲ho̲	tso̲ho̲	
dehe	dehe	
ye	ye	
däthe	däthe	
zabi	zabi	
däzabi	däzabi	
u	u	
do	do	
bomu	bomu	
fonthai	fonthai	
hai	hai	
gui	gui	
bo̲ngui	bo̲ngui	
mahets'i	mahets'i	
ndähi	ndähi	
xija	xija	
tse̲	tse̲	
tsiyu̲i	tsiyu̲i	
tsibi	tsibi	
bospi	bospi	
tsät'i	tsät'i	
ts’ixt’u‘ñu	ts’ixt’u‘ñu	
t'o̲ho̲	t'o̲ho̲	
the̲ni	the̲ni	
k’ants’i	k’ants’i	
k'axt'i	k'axt'i	
t'axi	t'axi	
bo	bo	
nxui	nxui	
pa	pa	
je̲ya	je̲ya	
mpani	mpani	
ntse̲	ntse̲	
ñuts'i	ñuts'i	
ra'yo	ra'yo	
xita	xita	
za	za	
nts'o	nts'o	
ya	ya	
nts'o	nts'o	
njwäntho	njwäntho	
tsant’i	tsant’i	
hye̲nte	hye̲nte	
doñä	doñä	
nts'u̲k	nts'u̲k	
nk'a	nk'a	
yot'i	yot'i	
hogi	hogi	
getu̲'bu̲	getu̲'bu̲	
ya'bu̲	ya'bu̲	
ñe̲i	ñe̲i	
ngähä	ngähä	
		
ja	ja	
-hu	-hu	
ne	ne	
nu'bu̲	nu'bu̲	
ngetho	ngetho	
thuhu	thuhu	