che	che	ʃe
nde	nde	nde
ha'e	ha'e	
ñande	ñande	ɲaˈnde
peẽ	peẽ	peˈẽ
ha'ekuéra	ha'ekuéra	
ko	ko	
pe	pe	
ko'ápe	ko'ápe	
upépe	upépe	
mávapa	mávapa	
mba'épa	mba'épa	ᵐba.ˈʔe.pa
mamópa	mamópa	
araka'épa	araka'épa	
mba'éichapa	mba'éichapa	
ani ...	ani ...	
pa	pa	
eta	eta	
mbovy	mbovy	
mbovy	mbovy	
ambue	ambue	
peteĩ	peteĩ	
mokõi	mokõi	
mbohapy	mbohapy	
irundy	irundy	
po	po	po
tuicha	tuicha	
puku	puku	pu.ˈku
pe	pe	
kyra	kyra	
pohýi	pohýi	
michĩ	michĩ	mĩˈɕ̃ĩ
mbyky	mbyky	ᵐbɨ.ˈkɨ
po'i	po'i	
pererĩ	pererĩ	
kuña	kuña	kũ.ˈɲã
kuimba'e	kuimba'e	kʷi.ᵐba.ˈʔe
tekove	tekove	
mitã'i	mitã'i	
tembireko	tembireko	
ména	ména	
sy	sy	
túva	túva	ˈtu.ʋa
mymba	mymba	
pira	pira	pi.ˈɾa
guyra	guyra	
jagua	jagua	
		
mbói	mbói	
taso	taso	
yvyra	yvyra	ɨ.ʋɨ.ˈɾa
ka'aguy	ka'aguy	
pokoka	pokoka	
yva	yva	
ta'ỹi	ta'ỹi	
togue	togue	
tapo	tapo	ta.ˈpo
		
yvoty	yvoty	ɨ.ʋo.tɨ
ka'a	ka'a	
sã	sã	
pire	pire	
so'o	so'o	
tuguy	tuguy	
kangue	kangue	
ñandy	ñandy	
tupi'a	tupi'a	
jepoka	jepoka	
tuguái	tuguái	
tague	tague	ta.ˈɰʷe
áva	áva	
akã	akã	ã.ˈk̃ã
nambi	nambi	
tesa	tesa	teˈsa
tĩ	tĩ	
juru	juru	d͡ʒu.ˈɾu
tãi	tãi	
kũ	kũ	
pyapẽ	pyapẽ	
py	py	pɨ
tetyma	tetyma	te.tɨˈma
		
po	po	po
pepo	pepo	
		
py'akue	py'akue	
ajúra	ajúra	
ape	ape	
káma	káma	
ñe'ã	ñe'ã	
py'akue	py'akue	
-'u	-'u	
karu	karu	
su'u	su'u	
pyte	pyte	
ndyvu	ndyvu	
guele'e	guele'e	
peju	peju	
pytuhẽ	pytuhẽ	
puka	puka	
echa	echa	
endu	endu	
kuaa	kuaa	kwaˈa
mo'ã	mo'ã	
hetũ	hetũ	
kyhyje	kyhyje	
ke	ke	
kove	kove	
mano	mano	
juka	juka	d͡ʒuˈka
ñorairõ	ñorairõ	ɲõɾ̃ãĩˈɾ̃õ
		
japete	japete	
kytỹ	kytỹ	
		
kutu	kutu	
karãi	karãi	
jo'o	jo'o	
yta	yta	
veve	veve	ʋeˈʋe
guata	guata	ɰʷaˈta
ju	ju	
ty	ty	
guapy	guapy	
pu'ã	pu'ã	
pyryrỹi	pyryrỹi	
-'a	-'a	
me'ẽ	me'ẽ	
reko	reko	
jopy	jopy	
kyty	kyty	
johéi	johéi	
ky'a'o	ky'a'o	
nohẽ	nohẽ	
muaña	muaña	
ty	ty	
ñapytĩ	ñapytĩ	
mbovyvy	mbovyvy	
papa	papa	
-e	-e	
purahéi	purahéi	
ñembosarái	ñembosarái	
vevýi	vevýi	
syry	syry	
To'ysâ	To'ysâ	
		
kuarahy	kuarahy	
jasy	jasy	d͡ʒa.sɨ
mbyja	mbyja	ᵐbɨ.ˈᵈja
y	y	ɨ
ama	ama	
ysyry	ysyry	ɨ.sɨ.ˈɾɨ
ypa	ypa	
para	para	
juky	juky	
ita	ita	
yvyku'i	yvyku'i	
yvytimbo	yvytimbo	
yvy	yvy	ɨ.ˈʋɨ
arai	arai	
tatatína	tatatína	
yvága	yvága	
yvytu	yvytu	ɨʋɨˈtu
yrypy'a	yrypy'a	
yrypy'a	yrypy'a	
tatatĩ	tatatĩ	
ata	ata	
kusugue	kusugue	
kái	kái	
ape	ape	
yvyty	yvyty	
pytã	pytã	
sa'yky	sa'yky	
sa'yju	sa'yju	
morotĩ	morotĩ	
ũ	ũ	
pyhare	pyhare	
ára	ára	
ary	ary	a.ˈɾɨ
haku	haku	ha.ˈku
ro'y	ro'y	ɾo.ʔɨ
enyhẽ	enyhẽ	
pyahu	pyahu	pɨ.a.ˈhu
tuja	tuja	tu.ˈd͡ʒa
porã	porã	põ.ˈɾã
vai	vai	va.ˈi
tuju	tuju	
ky'a	ky'a	
		
apu'a	apu'a	a.pu.ˈʔa
haimbe	haimbe	
		
sỹi	sỹi	ˈsɨ̃.ĩ
hykue	hykue	
kã	kã	
hekopete	hekopete	
âguĩ	âguĩ	
mombyry	mombyry	
akatúape	akatúape	
asúpe	asúpe	
-pe	-pe	
-pe	-pe	
ndive	ndive	
ha	ha	
... rõ	... rõ	
ajeve	ajeve	
éra	éra	