ixé	ixé	iˈʃɛ
endé	endé	ɛˈⁿdɛ
a'e	a'e	aˈʔɛ
îandé	îandé	jãˈⁿdɛ
peẽ	peẽ	
a'e	a'e	aˈʔɛ
ã	ã	
kûeî	kûeî	
iké	iké	
bõ	bõ	
abape	abape	
mba'epe	mba'epe	
umá	umá	
saê	saê	
pupé	pupé	puˈpɛ
inti	inti	
paûá	paûá	
tyba	tyba	
amó	amó	
mobyr	mobyr	
ambué	ambué	
oîepé	oîepé	ɔ.jɛˈpɛ
mokõi	mokõi	
mosapyr	mosapyr	mɔ.saˈpɨɾ
irundyk	irundyk	
xepó	xepó	
gûasu	gûasu	
puku	puku	puˈku
		
anama	anama	ãˈnã.ma
poxýi	poxýi	
mirĩ	mirĩ	miˈɾĩ
akytã	akytã	
mbé	mbé	
tapi	tapi	
kunhã	kunhã	kũˈɲã
abá	abá	aˈβ̞a
abá	abá	aˈβ̞a
kunumĩ	kunumĩ	
embireko	embireko	
mena	mena	
sy	sy	ˈsɨ
uba	uba	ˈu.βa
so'o	so'o	sɔˈʔɔ
pirá	pirá	piˈɾa
guirá	guirá	
îaguara	îaguara	
mukyrãna	mukyrãna	
mboîa	mboîa	ˈᵐbɔ.ja
miñoka	miñoka	
ybyrá	ybyrá	ɨ.βɨ.ˈɾa
ka'a	ka'a	-a
akã	akã	
ybá	ybá	ʔɨˈβa
si	si	
oba	oba	ˈɔ.βa
apó	apó	aˈpɔ
ibapé	ibapé	
potyra	potyra	pɔˈtɨ.ɾa
ka'apĩ	ka'apĩ	
sama	sama	
pira	pira	ˈpiɾa
o'o	o'o	ɔˈʔɔ
ugûy	ugûy	uˈɡwɨ
kanga	kanga	
kaba	kaba	
upiá	upiá	
aka	aka	
ûaia	ûaia	
aba	aba	ˈa.β̞a
aba	aba	ˈa.β̞a
a	a	
nambi	nambi	nãˈᵐbi
esá	esá	ɛˈsa
tĩ	tĩ	
îuru	îuru	juˈɾu ~ ʝuˈɾu
ãia	ãia	ˈãɲa
apekũ	apekũ	a.pɛˈkũ
		
py	py	ˈpɨ
etimã	etimã	
endypyã	endypyã	
pó	pó	ˈpɔ
pepó	pepó	
puruã	puruã	
py'a	py'a	pɨˈʔa
aîura	aîura	
kupé	kupé	
kama	kama	ˈkãma
ñiã	ñiã	
		
i-u	i-u	
karu	karu	kaˈɾu
su'u	su'u	
pyter	pyter	
mun	mun	
gûe'en	gûe'en	
peîu	peîu	
pytu	pytu	
puká	puká	
epîak	epîak	
endub	endub	
kuab	kuab	
moang	moang	
etun	etun	
sykyîé	sykyîé	
ker	ker	
ikobé	ikobé	
manõ	manõ	
îuká	îuká	juˈka
momaran	momaran	
		
petek	petek	
kûytĩ	kûytĩ	
bobok	bobok	
kutuk	kutuk	
eỹia	eỹia	
ybykoi	ybykoi	
ytab	ytab	
bebé	bebé	
gûatá	gûatá	
îur	îur	
moúba	moúba	
gûapyk	gûapyk	
am	am	
bak	bak	
ar	ar	
me'eng	me'eng	
rekó	rekó	
pyk	pyk	
kûytyk	kûytyk	
ei	ei	
		
no'ẽ	no'ẽ	
moanhan	moanhan	
ityk	ityk	
tĩ	tĩ	
poban	poban	
papar	papar	
e	e	
nhe'engar	nhe'engar	
nhemosarai	nhemosarai	
bebui	bebui	
		
		
mopungá	mopungá	
kûarasy	kûarasy	kʷa.ɾa.ˈsɨ
îasy	îasy	jaˈsɨ
îasytatá	îasytatá	jasɨtaˈta
y	y	ˈɨ
amana	amana	ãˈmãna
y	y	ˈɨ
upaba	upaba	
paranã	paranã	paɾãˈnã
îukyra	îukyra	
itá	itá	iˈta
ybyku'i	ybyku'i	ɨ.βɨ.kuˈʔi
tubyra	tubyra	
yby	yby	ɨˈβɨ
ybatinga	ybatinga	ɨ.βaˈtĩ.ŋa
ybytinga	ybytinga	ɨ.βɨˈtĩ.ŋa
ybaka	ybaka	ɨˈβ̞a.ka
ybytu	ybytu	ʔɨβɨˈtu
ro'yrypy'aka	ro'yrypy'aka	
ro'yrypy'aka	ro'yrypy'aka	
atatinga	atatinga	
atá	atá	aˈta
tanimbuka	tanimbuka	tanĩmˈbuka
kay	kay	
		
ybytyra	ybytyra	
pytang	pytang	pɨ.ˈtãŋ
oby	oby	ɔˈβɨ
îub	îub	juβ
ting	ting	
un	un	ˈũn
pytuna	pytuna	
ara	ara	ˈʔaɾa
seîxu	seîxu	sɛjˈʃu
akub	akub	aˈkub
ro'y	ro'y	ɾɔˈʔɨ
enysem	enysem	
pysasu	pysasu	
gûera	gûera	
katu	katu	
aíb	aíb	
îuk	îuk	
ky'á	ky'á	
atãnhé	atãnhé	
a	a	
aembe'e	aembe'e	
		
syma	syma	
akûyma	akûyma	
aku'i	aku'i	
katu	katu	
piri	piri	
apuê	apuê	
ekatuaba	ekatuaba	
asu	asu	
-pe	-pe	
-pe	-pe	
ndibé	ndibé	
none	none	
saé	saé	
mahy	mahy	
era	era	ˈɛ.ɾa