اکو‎	saye	
اڠکاو‎	awak	awaʔ
دي‎	die	
کيت‎	kite orang	
کامو‎	biskita	
مريک‎	die orang	
اين‎	ni	ni
ايت‎	tu	tu
سيني‎	kat sini	
سيتو‎	kat sane	
سياڤا‎	sape	
اڤ‎	ape	
مان‎	kat mane	
بيلا‎	bile	
باݢايمان‎	cane	
تيدق‎	bukan	bukan
سموا‎	sume	
باڽق‎	banyak	baɲak
ببراڤ‎	sebahagian	
سديکيت‎	sikit	sədikit
لاءين‎	beze	
ساتو‎	satu	satu
دوا‎	due	
تيݢ‎	tige	
امڤت‎	empat	əmˈpat
ليم‎	lime	
بسر‎	besak	
ڤنجڠ‎	panjang	pand͡ʒaŋ
ليبر‎	lapang	-aŋ
تبل‎	tebal	təbal
برت‎	berat	bərat
کچيل‎	kecik	
ڤينديق‎	pendek	
سمڤيت‎	himpit	
نيڤيس‎	nipis	nipis
ڤرمڤوان‎	puan	puan
للاکي‎	laki-laki	laki laki
اورڠ‎	kaum	
انق‎	budak	budak
ايستري‎	bini	bi.ni
سوامي‎	pakwe	
ايبو‎	emak	əmaʔ
باڤ‎	ayah	a.jah
بيناتڠ‎	haiwan	hai̯wan
ايکن‎	ikan	ikan
بوروڠ‎	burung	buroŋ
انجيڠ‎	hanjing	
کوتو‎	amu	
اولر‎	ula	
چاچيڠ‎	ula kecik	
ڤوکوق‎	pokok	pokokʔ
هوتن‎	hutan	hutan
باتڠ‎	tongkat	
بواه‎	buah	buah
بنيه‎	biji tunggul	
داءون‎	daun	daon
اکر‎	baniu	
کوليت کايو‎	kulit kayu	
بوڠا‎	bunga	buŋə
رومڤوت‎	balui	
تالي‎	temali	
کوليت‎	kulit	kulet
داݢيڠ‎	daging	daɡeŋ
داره‎	darah	darah
تولڠ‎	tulang	tulaŋ
لمق‎	lemak	ləmaʔ
تلور‎	telo	
تندوق‎	tanduk	tanduk̚
ايکور‎	bontot	
بولو‎	bulu	bulu
رامبوت‎	rambut	rambot, -o̞t, -ʊt
کڤالا‎	kepale	
تليڠا‎	telinga	təliŋə
مات‎	mate	
هيدوڠ‎	hidung	hidoŋ
مولوت‎	mulot	
ݢيݢي‎	gigi	ɡiɡi
ليده‎	lidah	lidah
کوکو‎	kuku	kuku
کاکي‎	kaki	kaki
کاکي‎	kaki	kaki
لوتوت‎	lutot	
تاڠن‎	tangan	ˈtaŋan
سايڤ‎	kepak	kəpaʔ
ڤروت‎	perut	pərot
اوسوس‎	usus	usos
ليهير‎	leher	lehe(r)
ڤوڠݢوڠ‎	belakang badan	
ڤايودارا‎	susu	susu
جنتوڠ‎	hati	hati
هاتي‎	hati	hati
مينوم‎	meminum	
ماکن‎	memakan	
ݢيݢيت‎	menggigit	
هيسڤ‎	hisap	hisap
لوده‎	meludah	
مونته‎	memuntah	
تيوڤ	hembus	həm.bus
نافس‎	hirup	hirup
کتاوا‎	sengeh	
ليهت‎	menjenawi	
دڠر‎	mendengar	
تاهو‎	reti	
فيکير‎	fikir	fike(r)
باو‎	menghidu	
تاکوت‎	takut	takut
تيدور‎	tidor	
هيدوڤ‎	hidup	hidop
ماتي‎	mati	mati
بونوه‎	bunoh	
لاون‎	memperjuangkan	
بورو‎	memburu	
ڤوکول‎	ketuk	
ڤوتوڠ‎	memutus	
بله‎	bahagi	
تيکم‎	cucuk	
ݢارو‎	calar	
ݢالي‎	menggali	
رنڠ‎	berenang	
تربڠ‎	berkepak	
جالن‎	jalan	d͡ʒalan
داتڠ‎	hadir	hadir
باريڠ‎	lampa	
دودوق‎	dok	
ديري‎	berdiri	
بيلوق‎	pusing	pu.sɪŋ
جاتوه‎	jatuh	
بري‎	kongsi	koŋ.si
ڤݢڠ‎	tahan	ta.han
ڤره‎	memerah	
ݢوسوق‎	sapu	sapu
چوچي‎	basuh	-uh
لڤ‎	sapu	sapu
تاريق‎	tarik	tarik
تولق‎	tolak	tolak
باليڠ‎	baling	baliŋ
ايکت‎	hikat	
جاهيت‎	jahit	d͡ʒa.hit
کيرا‎	kire	
کات‎	katakan	
ڽاڽي‎	bernyanyi	
ماءين‎	main	maen
اڤوڠ‎	terapung	
الور	salir	sale(r)
بکو‎	membekukan	
بڠکق‎	subei	
ماتاهاري‎	matehari	
بولن‎	bulan	bulan
بينتڠ‎	bintang	bintaŋ
اءير‎	ayer	
هوجن‎	hujan	hud͡ʒan
سوڠاي‎	sungai	suŋai̯
تاسيق‎	tasik	taseʔ
لاءوت‎	laot	
ݢارم‎	masin	masen
باتو‎	batu	batu
ڤاسير‎	pasir	pase(r)
هابوق‎	habuk	ha.buk
تانه‎	tanah	tanah
اون‎	awan	a.wan
کابوس‎	kabus	kabos
لاڠيت‎	langit	laŋit
اڠين‎	hangin	
ثلجي‎	salji	sald͡ʒi
اءير باتو‎	ais	aes
اسڤ‎	hasap	
اڤي‎	hapi	
ابو‎	jelebu	
باکر‎	bakar	
بالن‎	setapak	
ݢونوڠ‎	gunong	
ميره‎	merah	merah
هيجاو‎	hijau	hid͡ʒau̯
کونيڠ‎	kuning	kuneŋ
ڤوتيه‎	puti	
هيتم‎	itam	itam
مالم‎	malam	malam
سياڠ‎	tengah hari	təŋah hari
تاهون‎	tahun	tahon
ڤانس‎	panas	panas
سجوق‎	sejuk	səd͡ʒoʔ
ڤنوه‎	penoh	
بهارو‎	baharu	baharu
لاما‎	lame	
باءيق‎	sanggam	
بوروق‎	teruk	
بوسوق‎	reput	
کوتور‎	kotor	koto(r)
لوروس‎	terus	
بولت‎	bulat	-at
تاجم‎	tajam	
تومڤول‎	[[]]	
ليچين‎	licin	
باسه‎	basah	basah
کريڠ‎	kering	
بتول‎	betul	bətul
دکت‎	hampir	ham.pɪ(r)
جاءوه‎	jauh	d͡ʒaoh
کانن‎	kanan	kanan
کيري‎	kiri	kiri
د‎	kat	kat
ددالم‎	kat	kat
دڠن‎	ngan	ŋan
دان‎	dan	dan
کالاو‎	kalau	kalau̯
کران‎	sebab	səbap
نام‎	name	