aku	aku	
kamu	kamu	
ie	ie	
ite	ite	
		
		
ni	ni	
no	no	
leq te	leq te	
leq to	leq to	
sai	sai	
ape	ape	
leq mbe	leq mbe	
piran	piran	
kembe	kembe	
ndeq	ndeq	
slapuq	slapuq	
		
		
		
		
sekeq	sekeq	
due	due	
telu	telu	
mpat	mpat	
lime	lime	
beleq	beleq	
		
		
		
		
		
		
		
		
		
		
		
		
		
		
		
		
		
		
		
		
		
		
		
		
		
		
		
		
		
		
		
		
		
		
		
		
		
		
		
		
		
		
		
		
		
		
		
		
		
		
		
		
		
		
		
		
		
		
		
		
		
		
		
		
		
		
		
		
		
		
		
		
		
		
		
		
		
		
		
		
		
		
		
		
		
		
		
		
		
		
		
		
		
		
		
		
		
		
		
		
		
		
		
		
		
		
		
		
		
		
		
		
		
		
		
		
		
		
		
		
		
		
		
		
		
		
		
		
		
		
		
		
		
		
		
		
		
		
		
		
		
		
		
		
		
		
		
		
		
		
		
		
		
		
		
		
		
		
		
		
		
		
		
		
		
		
		
		
		
		
		
		
		
		
		
		
		
		
		
		