iyaw	iyaw	
inhu	inhu	
tene	tene	
kita	kita	
kamo	kamo	
naini	naini	
kata	kata	
kana	kana	
hia	hia	
hina	hina	
timang	timang	
mang	mang	
tumang	tumang	
mano	mano	
kimang	kimang	
asi	asi	
imid	imid	
banabana	banabana	
ruma	ruma	
ateten	ateten	
pani	pani	
caha'	caha'	
ruha	ruha	
toho	toho	
paha'	paha'	
hima	hima	
maiyan	maiyan	
mahandah	mahandah	
mahaway	mahaway	
makunum	makunum	
balau	balau	
bisibisi	bisibisi	
asi mahandah	asi mahandah	
masi'id	masi'id	
palipih	palipih	
mu'	mu'	
lak	lak	
pinalang	pinalang	
arak	arak	
gegat	gegat	
ekega	ekega	
ana'	ana'	
ama'	ama'	
ayayam	ayayam	
kahan	kahan	
ayam	ayam	
acu	acu	
kutu	kutu	
unut	unut	
ku'ay	ku'ay	
kayu	kayu	
bukun	bukun	
hukar	hukar	
vua	vua	
ahap	ahap	
lai	lai	
pata'	pata'	
[[]]	[[]]	
hana	hana	
kubuk	kubuk	
ta'ih	ta'ih	
halap	halap	
baat	baat	
amah	amah	
tu'an	tu'an	
imah	imah	
munusu	munusu	
tungaws	tungaws	
ikoh	ikoh	
ilin	ilin	
mukup	mukup	
mokot	mokot	
tangya	tangya	
mata	mata	
muhu	muhu	
nagut	nagut	
rahui	rahui	
rarira	rarira	
talukun	talukun	
ruma	ruma	
hyapan	hyapan	
kuran	kuran	
hima	hima	
payo	payo	
fupak	fupak	
parno	parno	
rari	rari	
atan	atan	
cucu	cucu	
timtim	timtim	
hupak	hupak	
abu'	abu'	
abu'	abu'	
ka'at	ka'at	
uho	uho	
dipah	dipah	
		
		
mita'uh	mita'uh	
macihaha	macihaha	
ukita	ukita	
kirara	kirara	
mavangara	mavangara	
pukidi purari	pukidi purari	
marangoh	marangoh	
takut	takut	
		
mabah	mabah	
kacai	kacai	
pakacai	pakacai	
masit	masit	
malu'	malu'	
apit	apit	
tmata	tmata	
pasapiah	pasapiah	
tmivur	tmivur	
		
kma'i	kma'i	
lmangoy	lmangoy	
apapayo	apapayo	
unaunang	unaunang	
tomehin	tomehin	
maniku	maniku	
mi'u'un	mi'u'un	
mituko	mituko	
dmikur	dmikur	
mineno	mineno	
panga	panga	
mara	mara	
pakaparupu	pakaparupu	
smidada	smidada	
madinu	madinu	
smidada	smidada	
vihit	vihit	
putuah	putuah	
smisit	smisit	
pukakud	pukakud	
mahoahoa	mahoahoa	
kutung	kutung	
pura	pura	
owaowao	owaowao	
mananah	mananah	
		
		
		
nunga	nunga	
isi	isi	
buan	buan	
kakiu	kakiu	
rarum	rarum	
uran	uran	
akam	akam	
pi	pi	
riyar	riyar	
vaya	vaya	
bato	bato	
li'ih	li'ih	
rapun	rapun	
unai	unai	
baun	baun	
baun	baun	
homuhomu	homuhomu	
vare	vare	
ula	ula	
ula	ula	
ato	ato	
apui	apui	
apu	apu	
tmatulu	tmatulu	
ra'an	ra'an	
bukin	bukin	
agaga'	agaga'	
tangya	tangya	
maocen	maocen	
mapuri	mapuri	
maolum	maolum	
kiyahutau ki maki	kiyahutau ki maki	
isi	isi	
tawin	tawin	
matak	matak	
mahangun	mahangun	
mabuba	mabuba	
vahu	vahu	
rie	rie	
mahanru	mahanru	
mausa	mausa	
mat'e mavitih	mat'e mavitih	
mausa	mausa	
matiktik	matiktik	
maritong	maritong	
marhingat	marhingat	
asi marhingat	asi marhingat	
kasai ki huping	kasai ki huping	
mahala	mahala	
markah	markah	
asi maparit	asi maparit	
to tamang	to tamang	
itu-tuah	itu-tuah	
pasiwan	pasiwan	
pasigit	pasigit	
to	to	
to	to	
lam ki	lam ki	
ka	ka	
hiro ka	hiro ka	
ali ka	ali ka	
n'nan	n'nan	